的	勺白	
一	一	一不上大而下里天其开无与三正业两应二或西立气更再直马五王求万争元士单具百亚武土兴严卫互丽鱼画雨灭丝妻舞丁拜乌鸟旦兼曹垂兽丛衰亏畏囊吏舆丙虐秉兀尹歹庚丞噩寅亟丕亘戌卅闩疟韭與橐蠹黃爰長豕
是	日𤴓	提题堤匙
不	③一	还否环怀坏杯歪甭丕钚
了	乛亅	疗函辽亨亟
在	③土	茬
人	人	人个大会从全内认金队夫火企众食介闪茶舍黎翰仓仑伞脊禽囚庚亥斡仄臾佘
有	月𠂇	郁贿肴囿宥
我	我	我俄饿哦鹅娥峨蛾
他	也亻	
这	文辶	
个	丨人	
们	亻门	
中	丨口	种冲钟忠仲肿囊衷忡盅橐蠹
来	来	来莱睐涞徕
上	⺊一	让卡忐
大	一人	天因美太达类参奇奥套夺奖奋庆奔尖奈牵契夸夷爽奎奠奢矢奕夭樊驮奄奂耷叁奘夯
为	为	为伪妫
和	口禾	
国	囗玉	帼蝈
地	也土	
到	刂至	倒
以	以	以似拟苡
说	兑讠	
时	寸日	
要	女覀	腰
就	京尤	鹫蹴
出	凵屮	础屈拙咄祟黜茁绌
会	云人	绘刽荟桧烩
可	丁口	何阿奇河哥呵柯苛珂诃轲坷舸
也	也	他地也她池驰弛
你	亻尔	您
对	又寸	树怼
生	生	生性星胜姓牲甥笙旌
能	䏍𫧇	熊
而	一𦓐	需耐耍斋
子	子	子学好存字李孩孙享季孔孤仔孟孕孝孽孜孚籽孺孢孪孛孳
那	二刀阝	哪娜挪
得	㝵彳	
于	于	于宇吁迂盂芋圩竽
着	目羊	
下	一卜	吓虾忑卞
自	自	自息首咱鼻臭瘪憩
之	②丶	乏芝
年	年	年
过	寸辶	挝
发	发	发废拨泼
后	口𠂋	垢逅诟
作	乍亻	
里	一甲	理量野童埋哩厘狸鲤俚锂
用	丨二冂	拥佣甭甬痈
道	辶首	
行	亍彳	
所	戶斤	
然	冫灬犬𠂊	燃
家	宀豕	嫁稼
种	中禾	
事	事	事
成	戊𠃌	城盛诚
方	丿亠𠃌	放房防族施旅旁访仿旋旗芳妨於纺坊肪彷旌舫旖鲂
多	夕	够移爹侈哆夥
经	纟𢀖	
么	丿厶	麽
去	厶土	法却罢丢劫怯祛
法	去氵	
学	冖子𭕄	
如	口女	恕絮茹
都	者阝	嘟
同	口𠔼	洞铜筒桐酮恫侗峒胴
现	王见	
当	⺌彐	档挡裆铛
没	殳氵	
动	云力	恸
面	丆囬	缅腼湎靥
起	巳走	
看	目龵	
定	宀𤴓	绽淀锭啶
天	一大	关吴奏吞蚕昊癸忝
分	八刀	份纷贫粉芬扮氛盆盼寡吩颁岔忿汾掰酚
还	不辶	
进	井辶	
好	女子	
小	小	小原尔少京孙尖尘雀
部	咅阝	
其	⑤一八	斯期基旗欺棋琪祺淇箕麒
些	二此	
主	亠土	住往注驻柱蛀拄
样	木羊	
理	王里	
心	心	心想意总感必思怎息念态志愿急您恶恩恐虑忽忘忍怒悲患愈忠悉恋慈慧惠惑慰怨惩闷悬愚忌悠愁恳惹恕芯怠沁憋忒忿怂憨恙恿恚恣忐忑懋憩懑怼
她	也女	
本	本	本体笨钵苯
前	䒑刖	箭剪煎翦
开	一廾	并形研刑邢妍
但	亻旦	
因	囗大	恩烟姻咽茵胭氤
只	八口	识织职积帜炽咫
从	人	两众坐纵丛耸巫怂枞苁
想	心相	
实	头宀	
日	日	是时日者明间最果更电复易早显星音普晚阳香景暗智鲁旧春暴替曼旦映暂晓晨昨昏曹昌晋旨晶暖昆晃昂晴昭旺晕晰旬昧昔龟旱晒晤旷暑暇暮晌旭晦曙曝晖曦耆暧沓晏暄晾昊昵曜昙杳晁晔昱暹晗昕杲間昶
军	冖车	挥辉浑晕晖荤诨恽
者	日耂	都著诸署绪猪赌屠堵睹煮奢暑褚赭渚
意	心音	臆噫薏
无	一尢	抚芜妩庑
力	丿𠃌	动加务边办功历另势男助伤劳勒努勇穷劲励勃劝勤幼劫劣勉勋虏勘募肋劾饬夯勖
它	匕宀	蛇陀驼舵鸵沱佗砣
与	②一	写屿欤
长	长	长张帐胀账怅
把	巴扌	
机	几木	
十	十	十什真计直南士质华支早古土千率协索叶博卖午妻毕针辛卑甫伞汁卒卉阜隼孛
民	民	民眠氓抿泯岷
第	竹𢎨	
公	八厶	松讼翁颂瓮蚣衮
此	匕止	些紫柴雌疵龇髭砦
已	已	已
工	工	工空式功红项江攻差左巧贡虹巫巩缸扛杠肛汞邛
使	亻吏	
情	忄青	
明	日月	盟萌
性	忄生	
知	口矢	智痴蜘
全	人王	栓拴痊诠荃铨
三	一二	兰丰叁仨
又	又	对又度变反受难权取观支仅紧双友欢汉坚圣戏曼叹鸡奴叔凤劝叙邓艰贤叉肾竖驭叟燮
关	丷天	联送郑朕
点	占灬	
正	一止	政证整征症怔歪焉罡
业	④一	亚显虚壶邺
外	卜夕	
将	丬𪧷	蒋锵
两	一从冂	辆俩
高	亠冋口	搞稿敲膏嵩镐蒿槁篙犒
间	日门	简涧锏
由	由	由黄油抽宙迪届邮袖庙轴笛釉铀寅胄柚岫黃
问	口门	
很	彳艮	
最	取日	撮
重	重	重董踵锺種
并	丷开	瓶拼屏饼迸骈姘
物	勿牛	
手	手	手拿掌摩拳攀摹挚擎挛掣掰
应	一广𭕄	
战	占戈	
向	丿冂口	响晌饷
头	头	实头买
文	乂亠	这刘齐纹斑坟斋斌虔蚊雯斐紊吝闵汶斓
体	亻本	
政	攵正	
美	大𦍌	羹镁
相	木目	想箱湘厢霜
见	见	现见规觉观视舰览觅觑砚觐觎觊靓苋笕
被	皮衤	
利	刂禾	莉梨犁俐痢蜊
什	亻十	
二	一	那用些三夫击半举毛云羊仁奉辰甩竺聿贰
等	寺竹	
产	丷亠厂	萨彦铲
或	一口戈	域惑阈
新	亲斤	薪
己	己	己记改纪配岂忌妃杞
制	冂刂牛	掣
身	身	身射躺躲躯躬
果	日木	课颗棵裸巢裹踝猓窠夥
加	力口	架驾贺嘉咖迦伽茄枷袈痂
西	一𠁤	牺洒栖晒茜哂硒
斯	其斤	撕嘶厮
月	月	有明月期望服青朝育脸股脑胜背脚胡肯朋脱阴骨朗胞腿胆胸肩腰胁腊腹脉肥脏腾臂肝肤肿肚赢胖腔肠肌膀膜胃脆胎肖肺胀甫胶脖脂脾脊腺膝肢肾膨膊钥胳腕膏腥腻朦隋胧膛胚肪肘脯朕朔腮肮臀胰膳豚惰肋脓肛胺腑腓腋胥臆膺脐胱滕胤腆腼胫腌胭胄臊臃嬴肽胯腴膑腎胛胪胝胴肓膘肱
话	舌讠	
合	亼口	给答拿哈恰拾盒鸽洽颌蛤龛
回	口囗	徊啬蛔洄
特	寺牛	
代	亻弋	袋贷黛岱
内	人冂	纳丙呐钠讷芮衲
信	亻言	
表	龶𧘇	婊裱
化	亻𠤎	花华货靴讹
老	匕耂	姥佬耆耄
给	合纟	
世	世	世泄屉
位	亻立	莅
次	冫欠	资盗姿茨瓷咨羡恣
度	又广廿	渡踱镀
门	门	们间问门闻闪闭闹阅闲阔阁闷闯阐阎阀闸闽闺阙闵阑阉阂闩闾闰阖扪闱闿阈闶阄闼阋阕
任	亻壬	凭赁
常	巾𫩠	嫦
先	儿𠂒	选洗宪酰诜铣
海	每氵	嗨
通	甬辶	嗵
教	孝攵	
儿	丿乚	先四克充竟鬼兄允匹兜詹兀
原	厂小白	愿源
东	东	东陈冻栋
声	士𠃜	
提	扌是	
立	一丷亠	位拉亲章音站端竞童辛粒竭泣竖靖垃妾笠竣翌飒翊昱竦竑
及	及	及极级吸圾汲笈岌芨
比	比	比批毕皆昆鹿屁毙庇毗琵砒
员	口贝	损圆勋陨殒郧
解	角𭷔	懈蟹邂
水	㇇丿乀亅	冰泉尿浆汞泵沓颍淼盥
名	口夕	铭茗
真	具十	镇慎填颠滇嗔缜稹
论	仑讠	
处	卜夂	咎
走	土龰	起越超赶徒趣赵趋赴趁陡趟赳趄趔
义	丶乂	议仪蚁
各	口夂	路格客略洛络阁胳咯骆赂烙骼恪酪铬珞
入	入	入
几	几	机几风亮凡虎沿凭凯凤朵肌玑饥咒凰秃凳讥叽矶亢冗夙麂
口	口	中和可后如同只知高问向或加合回员名各口听品告呢叫台石吗吧吃局号另响虽古足京害船否哪喜句哈占善啊右亮呼味吉毫叶吸呀含唐喝君嘴兄唯售哲吴沿喊啦召享唱咱叹启呆吹吓豪呈兽扣嘛吾吐咬鸣吨衰燕吕喷哀吞唤呵唇哦哩舌哼吻喘喂亭吟咽吵嗯吊啥唉咐喉吁亨吼嘱喃嚷喻哎吩啸嘲啡噢哑咳咖哨咨咕嘿嘻哇喀哗嗓哄哟咸呜叮铅喇嗣嗅叭嚼咧咯哉嘶喧嗡杏噪吱哺啪嗽咋嘟叨啤嘎呕喔叩呐哮啼呻咚嘘嗜咙唾吭咦嗦邑噜唬呃叱叽唔喽咎噬哆嚎嗤嗨嘀喳咪侃咄啃咆唠呛吠嘈啄噗咏呱嗒咀吝嗔吆哝嚓哧喋噶唆哽啧吮叼哒嗖咔唧嗳呸嗟嚏噎呗唷喙啜呷啾囔嗷嗫嗬嚅咂喏噤嘤啵啻咛嗥噼叵咻唑咝啮喟啕嘭唏呓唰噫嘁咣喵啷嗑噙嗝啐辔嘹嗲哂呶噘噔咤嗵咿嗪咩啶呤唁喑
认	人讠	
条	夂朩	涤绦
平	丷干	评苹坪砰抨怦秤
系	丿糸	
气	一乁𠂉	汽氧氛氢氯氨氮氖氟氦氲氰氤氩
题	是页	
活	氵舌	阔
尔	小𠂊	你称弥玺迩
更	一乂日	便硬梗哽埂
别	刂另	
打	丁扌	
女	女	要如好她女安始委威妈姐娘妇婚姑姆妻姓妹妙奶婆奴媒娜嫌娃妥妖妨姿奸姻嫁妄婴妮嫂娇姊耍姨媚姚媳姜娱娶嫩汝娟妃妒妆姬嫉妓娥婉姥娅婶婢婪婿嫦妞娴妾嬉嫖嫣妊娼娠婷嫡姗媲婵嫔娓娄妩媛娩婊娲娑孀妫嬴媾婀姣妍娣囡妲嬗妪嬷姘婕媸
变	亦又	
四	儿囗	泗
神	申礻	
总	心𠮦	聪
何	亻可	荷
电	乚日	奄
数	娄攵	擞薮
安	女宀	案按氨鞍胺晏
少	丿小	省沙妙劣秒吵抄纱炒钞砂
报	扌𠬝	
才	才	才团财材闭豺
结	吉纟	
反	又𠂆	版板饭返叛贩扳阪皈坂
受	冖又爫	授绶
目	目	着看相目眼省睛督睡冒泪眉瞧盯睁眠瞪盲瞬盼鼎眨瞎瞒瞄睹瞥瞅眩眯瞻眷睦眶睬瞩眺眸睫瞟瞳瞰睑睽睐眈瞠瞌盹瞑睢瞭睨
太	丶大	态汰钛肽
量	旦里	
再	一冉	
感	咸心	憾撼
建	廴聿	健键
务	力夂	雾
做	亻故	
接	妾扌	
必	丿心	秘瑟泌宓
场	土𠃓	
件	亻牛	
计	十讠	
管	官竹	
期	其月	
市	亠巾	闹柿
直	一且十	值置植殖矗
德	彳𢛳	
资	次贝	
命	亼叩	
山	山	山密岁岛岸仙岩峰崇幽岂峡岗岳崩岭崖炭峻崔灿屿岚崎嵌峭崭峙峨崛岔巍嵩岑讪崽巅峦嵋屹汕岐岖岬岱嵇岌峪嶙峋崂峒崴岷岫嵘峁嶂峥崆
金	丷人王	鉴鑫鋆銮鋈淦鍪鎗鏖錾鏡
指	扌旨	
克	儿古	兢
许	午讠	浒
统	充纟	
区	㐅匚	欧驱躯枢呕殴鸥岖抠讴妪沤
保	亻呆	堡褒葆煲褓
至	土𠫔	到致室屋侄窒臻蛭郅桎
队	人阝	坠
形	开彡	
社	土礻	
便	亻更	鞭
空	工穴	控腔崆
决	冫夬	
治	台氵	
展	丿乀尸龷𠄌	辗碾
马	②一	吗验妈玛驻码骑骂骗驱驶驾腾冯驳骤驰闯骚骄骇驴驼驯骆蚂蓦笃骏羁骡驭驮驿驹骥骋驸骁骧骈骛骅骞骊
科	斗禾	蝌
司	𠃌𠮛	词饲嗣伺祠笥
五	一𫝀	伍吾
基	其土	
眼	目艮	
书	书	书
非	非	非排罪靠悲菲辈匪啡斐靡徘裴诽腓绯扉翡韭蜚霏俳
则	刂贝	测侧厕恻铡
听	口斤	
白	白	的原白百怕皇伯迫拍皆帕柏泉泊卑舶魄兜珀皓皂皖皈帛皑皋皙皎粕铂
却	卩去	脚
界	介田	
达	大辶	哒鞑挞闼
光	⺌兀	辉晃耀恍胱觥咣
放	攵方	
强	弓虽	犟
即	⑤卩	唧鲫
像	亻象	
难	又隹	滩摊瘫傩
且	且	直且组具助姐县祖阻宜租粗寡沮诅咀狙疽蛆趄俎
权	又木	
思	心田	惫腮崽鳃
王	一土	现理全金望球环皇班玉弄玩狂玛珠珍瑞呈玻玲汪璃斑璇玑旺琼玫琳瑰珊琐瑜瑶枉琢琉珀瑛琪瑚匡璋琦琛瑙顼琅珂釜珑瑾璐琏瑕珥璞瓒玷闰璜琥琨珞琬璨瑁璀
象	𠂊𧰨𫩏	像豫橡
完	元宀	院皖莞浣烷
设	殳讠	
式	工弋	试轼拭弑
色	巴𠂊	绝艳
路	各𧾷	露璐潞鹭
记	己讠	
南	冂十𢆉	献喃楠
品	口吅	
住	主亻	
告	口𠂒	造靠浩酷皓窖诰鹄梏
类	大米	
求	一丶氺	球救裘
据	居扌	
程	呈禾	
北	③匕	背乘燕乖冀
边	力辶	
死	匕歹	葬毙
张	弓长	涨
该	亥讠	
交	亠父	较效校咬胶郊狡绞蛟饺跤佼皎铰姣
规	夫见	窥
万	一丿𠃌	厉迈
取	又耳	最趣聚娶
拉	扌立	啦
格	各木	
望	亡月王	
觉	冖见𭕄	搅
术	丶木	述怵
领	令页	
共	八龷	供洪恭巷哄拱粪龚烘
确	石角	
传	专亻	
师	丨丿帀	狮筛蛳
观	又见	
清	氵青	
今	㇇亽	念含琴贪吟岑矜黔芩
切	七刀	彻窃砌沏
院	完阝	
让	上讠	
识	只讠	
候	ユ丨亻矢	
带	冖卅巾	滞
导	寸巳	
争	コ一亅𠂊	静净挣睁铮筝狰诤峥
运	云辶	
笑	夭竹	
飞	飞	飞
风	㐅几	飘疯讽岚枫飙飓飕飒飚
步	止𣥂	涉频
改	己攵	
收	丩攵	
根	木艮	
干	干	平干赶刊汗肝奸杆罕轩旱竿噩鼾秆矸
造	告辶	糙
言	言	信言警誉誓譬詹這燮詈唁謇誊
联	关耳	
持	寺扌	
组	且纟	
每	母𠂉	海梅敏悔霉侮毓酶晦诲莓
济	氵齐	
车	车	军车转连轻较阵输载软轮库轰辑辆辈辖轨辅舆轩辐轴轿斩轼辙轧辗辄辘辕轲轶辍辎辏辔轱轭
亲	朩立	新
极	及木	
林	木	楚梦禁森麻淋琳焚彬婪霖梵麓
服	月𠬝	
快	夬忄	筷
办	八力	苏协胁
议	义讠	
往	主彳	
元	一兀	完远园玩顽寇阮沅
英	央艹	瑛
士	一十	声志款吉壮壳壶仕壬壹
证	正讠	
近	斤辶	
失	丿夫	铁跌秩迭佚轶
转	专车	
夫	二人	规失养扶夹肤芙趺蚨
令	亽龴	领冷零龄怜邻玲铃岭伶拎翎聆羚苓蛉呤
准	冫隹	
布	巾𠂇	希怖
始	台女	
怎	乍心	
呢	口尼	
存	③子	荐
未	未	未味妹昧魅寐
远	元辶	
叫	丩口	
台	厶口	治始抬胎怡冶怠苔殆贻诒迨笞
单	一丷甲	弹禅阐蝉惮婵郸掸觯
影	彡景	
具	一且八	真惧俱飓
罗	夕罒	逻萝锣椤箩
字	子宀	
爱	冖友爫	暧嗳
击	丨二凵	陆
流	㐬氵	
备	夂田	
兵	丘八	宾浜
连	车辶	莲链琏涟
调	周讠	
深	氵罙	
商	丷亠冏	熵墒
算	竹𥃲	
质	十贝𠂆	
团	囗才	
集	木隹	
百	一白	陌弼
需	而雨	儒懦蠕孺嚅糯濡
价	亻介	
花	化艹	
党	兄龸	傥
华	化十	哗桦晔烨骅
城	土成	
石	丆口	确研破础硬码碰矿碎岩碍磨磁碗碧碑砍拓硕砖砸碌砂硫碳碟砰碱磅礁磷磕硝砌矶磋硅磊砾磺磐碉碘碾泵砚砥宕碴砧砷矾硼蠹斫砺砭碣碛硒硎礴砣碜砒砦矸
级	及纟	
整	敕正	
府	付广	腐俯腑
离	㐫禸	璃禽篱漓魑
况	兄冫	
亚	一业	恶晋哑娅垩桠氩
请	讠青	
技	扌支	
际	示阝	
约	勺纟	药哟
示	示	际示标宗款票禁奈祭禀祟佘
复	夂日𠂉	腹蝮愎馥
病	丙疒	
息	心自	媳熄螅
究	九穴	
线	戋纟	
似	亻以	
官	㠯宀	管馆棺倌绾
火	人八	灵炮灭烟炸伙灯秋烧爆烦灰炎灾燃煤烂炼炉狄焰煌焚烛炒灿燥烤耿灶烁焕熄灼烫炯炕熔煽炳烘炽炫炊荧炬烙烬炙煜炖焙烽灸燎焊煊熠熵烯烷炀燮燔熨烨燧烩煨炜煲焓烃烊炔
断	斤米𠃊	
精	米青	
满	氵𬜯	懑
支	十又	技鼓枝翅歧肢妓吱伎岐庋
视	礻见	
消	氵肖	
越	戉走	樾
器	吅犬	
容	宀谷	溶蓉熔镕榕
照	昭灬	
须	彡页	
九	九	究九杂仇轨丸旭鸠馗
增	土曾	
研	开石	
写	与冖	泻
称	尔禾	
企	人止	
八	八	分其只公共办具兵火八六兴黄父率益典穴函脊舆叭兮趴扒睿寅犀與黃
功	力工	
吗	口马	
包	勹巳	跑炮抱胞饱泡鲍袍咆刨苞雹疱庖孢龅
片	片	片版牌牒牍
史	史	史驶吏
委	女禾	魏矮萎倭诿痿
乎	乎	乎呼
查	旦木	渣喳碴楂
轻	车𢀖	
易	勿日	锡赐踢惕剔蜴
早	十日	章草卓覃
曾	丷𭥴	增僧赠憎蹭甑
除	余阝	
农	冖𧘇	浓侬脓哝
找	戈扌	
装	壮衣	
广	广	应度府广底座序席康庭唐庄店扩床库麻庆废矿廉庞庙鹿廊庸旷庇廖廓庐庶庵庚庖庑庋庠犷邝庾
显	业日	湿
吧	口巴	
阿	可阝	啊婀
李	子木	
标	木示	
谈	炎讠	
吃	乞口	
图	冬囗	
念	今心	捻
六	亠八	
引	丨弓	蚓
历	力厂	雳沥
首	䒑自	道馗
医	匚矢	
局	口尸𠃌	
突	犬穴	
专	专	传转专砖抟
费	弗贝	
号	丂口	
尽	⺀尺	烬荩
另	力口	别拐
周	⺆𠮷	调雕绸稠碉凋惆倜
较	交车	
注	主氵	
语	吾讠	
仅	亻又	
考	丂耂	烤拷铐
落	洛艹	
青	月龶	情清请精静睛猜晴靖倩菁蜻氰靓
随	迶阝	
选	先辶	
列	刂歹	例烈裂咧洌冽趔
武	一弋止	赋斌鹉
红	工纟	荭
响	口向	
虽	口虫	强
推	扌隹	
势	力执	
参	厶大彡	惨渗掺碜
希	㐅布	稀烯唏
古	十口	克故苦居胡固姑估枯咕辜沽骷轱钴祜
众	人从	
构	勾木	
房	户方	
半	丨丷二	判伴叛胖畔衅绊拌
节	丨艹𠃌	栉
土	一十	在地去主走场至社基王城增型境坐坚块坏域幸均圣堂坦庄塔塞埃培墙杜堆壁丧墨堡坡埋吐赤尘肚坛堪墓址寺填疆塑圳坑坠堵垄坟壤垒塘坎堤塌坊垫垃圾堕垮灶坪坝墅坤垣墟牡垦壕埔坞垢堑埠堰坍圭墩坯啬塾坷壑坂垛圪埂圩垠墒坳埽垩钍圻
投	扌殳	
某	木甘	谋媒煤
案	安木	
黑	⑧灬	默墨嘿黛黯黝黔黜黠
维	纟隹	潍
革	革	革勒鞋鞭鞘鞠靴鞍靶羁鞅靳鞑靼鞯
划	刂戈	
敌	攵舌	
致	攵至	
陈	东阝	
律	彳聿	
足	口龰	促捉蹙蹩龊
态	太心	
护	户扌	
七	㇀乚	切皂
兴	一八𭕄	举誉
派	氵𠂢	
孩	亥子	
验	佥马	
责	贝龶	债绩啧渍碛赜
营	吕𫇦	
星	日生	醒猩腥惺
够	句多	
章	早立	障彰璋赣漳樟蟑瘴嶂
音	日立	意竟暗韵黯韶谙歆喑
跟	艮𧾷	
志	士心	痣
底	广氐	
站	占立	
严	④一厂	俨
巴	巴	把色吧巴爸爬肥疤芭邑靶琶笆耙粑
例	亻列	
防	方阝	
族	方矢𠂉	簇
供	亻共	
效	交攵	
续	卖纟	
施	㐌方	
留	③刀田	溜瘤榴遛馏镏
讲	井讠	
型	刑土	
料	斗米	
终	冬纟	
答	合竹	
紧	〢又糸	
黄	八由龷	横簧磺璜潢
绝	纟色	
奇	可大	骑寄椅倚崎畸琦绮犄旖
察	宀祭	擦嚓
母	母	每母毒姆拇
京	亠口小	就惊景凉掠谅琼鲸晾椋
段	⑤殳	锻缎
依	亻衣	
批	扌比	
群	君羊	
项	工页	
故	古攵	做
按	安扌	
河	可氵	菏
米	米	类断精料米继奥迷粮糊粗粉粒粹糖糟粘糕粟粪眯粥糙粤咪屎彝籽粱糜娄糠糯粑粕麋粲
围	囗韦	
江	工氵	鸿
织	只纟	
害	口𫲸	辖割瞎豁
斗	斗	科料斗抖斜魁斟蚪斡斛
双	又	轰聂
境	土竟	
客	各宀	额喀
纪	己纟	
采	木爫	彩菜踩睬
举	丨二兴	榉
杀	㐅朩	刹铩弑
攻	工攵	
父	乂八	交爷爸爹斧釜
苏	办艹	
密	宓山	
低	亻氐	
朝	月𠦝	潮嘲
友	又𠂇	爱爰
诉	斥讠	
止	止	此正步企武止肯址歧扯耻涩趾芷祉
细	田纟	
愿	原心	
千	丿十	迁歼舌纤乖忏
值	亻直	
仍	乃亻	
男	力田	舅甥
钱	戋钅	
破	皮石	
网	㐅冂	
热	执灬	
助	且力	锄
倒	亻到	
育	月𠫓	撤辙澈唷
属	尸禹	嘱瞩
坐	从土	座挫唑锉痤
帝	丷亠冖巾	蒂蹄缔啼谛啻
限	艮阝	
船	口舟𠘧	
脸	佥月	
职	只耳	
速	束辶	
刻	亥刂	
乐	乐	乐烁砾栎
否	不口	痞
刚	冈刂	
威	女戌	崴
毛	丿乚二	毫笔尾耗毯髦毡麾耄蚝
状	丬犬	
率	丷八十玄	摔蟀
甚	⑤匹	堪勘斟湛谌戡
独	犭虫	
球	求王	
般	殳舟	搬磐瘢
普	並日	谱
怕	忄白	
弹	单弓	
校	交木	
苦	古艹	
创	仓刂	
假	亻叚	
久	久	久疚灸
错	昔钅	
承	承	承
印	③卩	
晚	免日	
兰	三丷	烂拦栏
试	式讠	
股	月殳	
拿	合手	
脑	㐫月	
预	予页	
谁	讠隹	
益	䒑八皿	溢隘谥缢
阳	日阝	
若	右艹	诺惹匿偌喏
哪	口那	
微	彳𢼸	薇
尼	匕尸	呢泥妮昵伲怩
继	米纟𠃊	
送	关辶	
急	刍心	隐稳
血	丿皿	衅恤
惊	京忄	
伤	亻力𠂉	
素	糸龶	愫
药	约艹	
适	舌辶	
波	氵皮	婆啵菠
夜	丶亠亻夂	液腋掖
省	少目	
初	刀衤	
喜	口壴	禧嘻嬉熹僖
卫	一丨𠃌	
源	原氵	
食	人良	餐饕飧飨
险	佥阝	
待	寺彳	
述	术辶	
陆	击阝	
习	冫𠃌	羽
置	直罒	
居	古尸	据剧锯踞
劳	力𫇦	捞唠涝崂痨
财	才贝	
环	不王	
排	扌非	
福	畐礻	
纳	内纟	
欢	又欠	
雷	田雨	蕾擂镭
警	敬言	
获	犾艹	
模	木莫	
充	儿𠫓	统
负	贝𠂊	赖
云	二厶	会动运层魂尝坛芸酝耘纭昙
停	亭亻	
木	木	样机相果权格术根极林集查李标构某案采校模木树村检概核架困枪楼松板材宋森杨床析休植杰染梅杜桥横呆杯梁枝桑闲柳朵柔柏械椅梯柱档桃枚柯桂棉柴柜杆棋朴栏棵框枯柄棍棒寨渠杭栽桶杖棚椎栖株棠桩桓朽榜栗枕枢榴梭棺栋桐梳杉棕樱梢杏橡棱枉梗栓桨槽栅梨榻橱杠檐槐椒栈札楞枫榆桔椭柿梧槛樵檀沐橄楷桅橙禾榄橘榨枷楠桢栩梓杞楔桦枭椰檬榈橇椋槟楣梆樟桀桧槌榕橹椿棣柠柑杳榭榔栾榘榷椤椽槁枞杈柚柩枸榛樽榉栉梏檄栎桎楂楹杵樾楫桠杲榫槭橛
游	斿氵	
龙	丿尤	袭庞笼垄拢宠胧聋咙龚陇珑龛茏泷
树	对木	
疑	疋龴𠤕	凝
层	云尸	
冷	令冫	
洲	州氵	
冲	中冫	
射	寸身	谢麝榭
略	各田	
范	氾艹	
竟	儿音	境镜鏡
句	勹口	够狗拘苟驹枸
室	宀至	
异	巳廾	
激	敫氵	
汉	又氵	
村	寸木	
哈	口合	
策	朿竹	
演	寅氵	
简	竹间	
卡	上卜	咔
罪	罒非	
判	刂半	
担	扌旦	
州	州	洲州酬
静	争青	
退	艮辶	腿褪
既	⑤旡	概慨溉暨厩
衣	亠𧘇	装依裁袭袋裂裔裳裘裴袅裟铱袈
您	你心	
宗	宀示	综崇踪棕淙鬃
积	只禾	
余	亼朩	除途徐叙涂斜荼馀
痛	甬疒	
检	佥木	
差	工羊	搓磋嗟
富	宀畐	
灵	彐火	
协	办十	
角	角	解确角触觯斛觥
占	⺊口	点战站店贴钻粘沾帖毡拈黏玷鲇砧乩苫
配	己酉	
征	彳正	惩
修	丨亻夂彡	
皮	皮	被破波皮彼坡颇玻疲皱披跛陂
挥	军扌	
胜	月生	
降	夅阝	
阶	介阝	
审	宀申	婶
沉	冗氵	
坚	〢又土	铿
善	䒑口羊	膳缮蟮鳝
妈	女马	
刘	刂文	
读	卖讠	
啊	口阿	
超	召走	
免	⑤𠂊	晚勉挽兔冕娩
压	厂圡	
银	艮钅	
买	乛头	卖
皇	王白	煌惶凰蝗徨隍湟
养	䒑丨丿夫	
伊	亻尹	咿
怀	不忄	
执	丸扌	势热垫挚亵蛰
副	刂畐	
乱	乚舌	
抗	亢扌	
犯	㔾犭	
追	辶𠂤	槌
帮	巾邦	
宣	亘宀	喧渲暄煊萱
佛	亻弗	
岁	夕山	秽
航	亢舟	
优	亻尤	
怪	圣忄	
香	日禾	馨馥
著	者艹	躇
田	田	界思备留细男雷略田鱼画奋累番苗胃畜畏亩甸畴畔畸佃毗町畹畿畦
铁	失钅	
控	扌空	
税	兑禾	
左	工𠂇	佐隋惰
右	口𠂇	若佑祐
份	亻分	
穿	牙穴	
艺	乙艹	呓
背	北月	
阵	车阝	
草	早艹	
脚	却月	
概	既木	
恶	亚心	
块	土夬	
顿	屯页	
敢	乛攵耳	橄憨瞰
守	宀寸	狩
酒	氵酉	
岛	④山	捣
托	乇扌	
央	央	英央映盎鞅秧殃鸯怏泱
户	丶尸	房护启肩扁雇炉扇芦驴妒沪庐扈扉戾
烈	列灬	
洋	氵羊	
哥	可	歌
索	冖十糸	嗦
胡	古月	湖糊蝴瑚葫
款	士欠示	
靠	告非	
评	平讠	
版	反片	
宝	宀玉	
座	坐广	
释	釆𠬤	
景	京日	影憬
顾	厄页	
弟	丷𢎨	递梯涕剃娣悌
登	癶豆	瞪凳澄蹬橙簦噔
货	化贝	
互	一彑	
付	亻寸	府附符咐驸苻
伯	亻白	
慢	忄曼	
欧	区欠	
换	奂扌	
闻	耳门	
危	㔾厃	脆跪诡桅
忙	亡忄	
核	亥木	
暗	日音	
姐	且女	
介	丨丿人	界价阶尬芥
坏	不土	
讨	寸讠	
丽	一丶冂	俪骊
良	丶艮	食娘浪粮狼酿踉琅
序	予广	
升	丿廾	
监	〢丶皿𠂉	蓝滥篮尴槛褴
临	〢丶𠂉𫩏	
亮	亠冖几口	
露	路雨	
永	永	永脉泳咏昶
呼	乎口	
味	口未	
野	予里	墅
架	加木	
域	土或	
沙	少氵	莎鲨娑裟
掉	卓扌	
括	扌舌	
舰	舟见	
鱼	一田𠂊	鲁鲜渔鲍稣鲸鳞鳍鲤鳌鲨鳄鳃鳖鳎鳗鲇鲫鲈鲑鳅鳝鱿鲟鲂
杂	九朩	
误	吴讠	
湾	弯氵	
吉	口士	结洁桔诘颉秸髻黠拮結
减	冫咸	
编	扁纟	
楚	林疋	
肯	月止	啃
测	则氵	
败	攵贝	
屋	尸至	握喔渥龌幄
跑	包𧾷	
梦	夕林	
散	⺼攵龷	撒霰
温	昷氵	
困	囗木	捆
剑	佥刂	
渐	斩氵	
封	圭寸	
救	攵求	
贵	贝𠀐	遗溃馈匮
枪	仓木	
缺	夬缶	
楼	娄木	
县	且厶	悬
尚	⺌冋	躺倘趟敞淌
毫	亠冖口毛	
移	多禾	
娘	女良	
朋	月	鹏崩棚绷硼
画	一凵田	
班	②王	
智	日知	
亦	④亠	变迹恋弯蛮奕挛峦鸾銮孪栾弈
耳	耳	取联职敢闻耳耶聪聊耸耻聘耽耿聂聋饵茸聆珥耷弭
恩	因心	嗯摁
短	矢豆	
掌	手𫩠	撑
恐	巩心	
遗	贵辶	
固	古囗	涸锢
席	巾广廿	
松	公木	淞凇
秘	必禾	
谢	射讠	
鲁	日鱼	噜撸橹
遇	禺辶	
康	广隶	慷糠
虑	心虍	滤
幸	土𢆉	悻
均	匀土	鋆筠
销	肖钅	
钟	中钅	
诗	寺讠	
藏	臧艹	
赶	干走	
剧	刂居	
票	示覀	飘漂镖嫖瞟瓢剽缥膘
损	员扌	
忽	勿心	惚
巨	巨	巨距拒柜矩炬钜苣
炮	包火	
旧	丨日	
端	立耑	
探	扌罙	
湖	氵胡	
录	彐氺	绿剥禄碌氯箓渌
叶	十口	
春	日𡗗	蠢椿
乡	乡	乡雍飨
附	付阝	
吸	及口	
予	龴𠄐	预序野舒豫抒纾
礼	乚礻	
港	巷氵	
雨	一𠕒	需雷露雪震零霍雾霸霞霉霆霜雯霄霖霎霹雳霓雹霭霾霁霰霏
呀	口牙	
板	反木	
庭	广廷	
妇	女彐	
归	丨丿彐	
睛	目青	
饭	反饣	
额	客页	
含	今口	颔晗焓
顺	川页	
输	俞车	
摇	䍃扌	
招	召扌	
婚	女昏	
脱	兑月	
补	卜衤	
谓	胃讠	
督	叔目	
毒	母龶	
油	氵由	
疗	了疒	
旅	④方𠂉	
泽	氵𠬤	
材	才木	
灭	一火	
逐	豕辶	
莫	旲艹	模幕摸漠墓膜慕寞募暮摹蓦谟蟆馍
笔	毛竹	
亡	亠𠃊	望忙忘盲妄芒氓邙虻肓
鲜	羊鱼	癣藓
词	司讠	
圣	又土	怪
择	扌𠬤	
寻	寸彐	荨鲟浔
厂	厂	产原历严压厂厅厚厉厌厨厘厦辰厄厢雁厥厕厮厩仄厝
睡	垂目	
博	十尃	
勒	力革	
烟	因火	
授	受扌	
诺	若讠	
伦	亻仑	
岸	厈山	
奥	丿冂大米	澳噢懊
唐	口广肀	糖塘搪
卖	买十	续读赎窦渎犊牍
俄	亻我	
炸	乍火	
载	车𢦏	
洛	各氵	落
健	亻建	
堂	土𫩠	膛瞠螳
旁	丷亠冖方	膀镑榜傍磅谤螃滂
宫	吕宀	
喝	口曷	
借	亻昔	
君	口尹	群郡裙窘
禁	林示	襟噤
阴	月阝	荫
园	元囗	
谋	某讠	
宋	宀木	
避	辟辶	
抓	扌爪	
荣	艹𣎾	嵘
姑	古女	菇
孙	子小	逊荪
逃	兆辶	
牙	牙	穿呀牙雅邪讶鸦芽伢蚜
束	束	速束赖辣敕悚剌竦
跳	兆𧾷	
顶	丁页	
玉	丶王	国宝莹璧玺钰
镇	真钅	
雪	彐雨	
午	十𠂉	许杵
练	纟𫠣	
迫	白辶	
爷	卩父	
篇	扁竹	
肉	肉	肉腐
嘴	口觜	
馆	官饣	
遍	扁辶	
凡	丶几	赢巩帆梵嬴矾
础	出石	
洞	同氵	
卷	㔾龹	圈倦蜷绻
坦	土旦	
牛	牛	物制特件牛牧牲牵牢牺牟牡犁犀犊犟犄犒
宁	丁宀	拧狞泞柠咛
纸	氏纟	
诸	者讠	储
训	川讠	
私	厶禾	
庄	土广	脏桩赃
祖	且礻	
丝	②一	咝
翻	番羽	
暴	㳟日	爆瀑曝
森	木林	
塔	土荅	
默	犬黑	
握	屋扌	
戏	又戈	
隐	急阝	瘾
熟	孰灬	
骨	⑤月	滑骸髓猾骼骷髅骰體鹘骶
访	方讠	
弱	冫弓	溺
蒙	冡艹	朦檬
歌	哥欠	
店	占广	惦掂踮
鬼	儿厶甶	魔魂魏愧瑰魄魁魅槐傀魇魑隗
软	欠车	
典	⑥八	碘腆
欲	欠谷	
萨	产艹阝	
伙	亻火	
遭	曹辶	
盘	皿舟	
爸	巴父	
扩	广扌	
盖	皿𦍌	
弄	廾王	
雄	厷隹	
稳	急禾	
忘	亡心	
亿	乙亻	
刺	刂朿	
拥	扌用	
徒	彳走	
姆	女母	
杨	木𠃓	
齐	丨丿文	济剂挤脐跻霁蛴
赛	贝𡨄	
趣	取走	
曲	曲	曲曹蛐
刀	丿𠃌	那分切留初贸召券剪劈刃叨
床	广木	
迎	卬辶	
冰	冫水	
虚	业虍	墟嘘觑
玩	元王	
析	斤木	晰蜥皙淅
窗	囱穴	
醒	星酉	
妻	コ一十女	凄
透	秀辶	
购	勾贝	
替	㚘日	潜
塞	土𡨄	
努	力奴	
休	亻木	咻
虎	几虍	彪唬琥虢
扬	扌𠃓	
途	余辶	
侵	亻𠬶	
刑	刂开	型硎
绿	录纟	
兄	儿口	党况竞祝兑
迅	卂辶	
套	大镸	
贸	③刀贝	
毕	十比	跸
唯	口隹	
谷	谷	容欲谷俗裕浴豁峪
轮	仑车	
库	广车	裤
迹	亦辶	
尤	丶尢	就龙优犹忧扰稽疣嵇鱿
竞	兄立	
街	亍圭彳	
促	亻足	
延	③丿廴	诞蜒涎筵
震	辰雨	
弃	廾𠫓	
甲	甲	里单甲押鸭匣闸钾呷岬胛
伟	亻韦	
麻	广林	摩魔磨嘛麽靡糜麾
川	川	顺训川圳驯卅
申	申	神审申伸畅绅坤呻砷
缓	爰纟	
潜	替氵	
闪	人门	
售	口隹	
灯	丁火	
针	十钅	
哲	口折	
络	各纟	
抵	扌氐	
朱	朱	朱殊珠株蛛诛铢侏
埃	土矣	
抱	包扌	
鼓	壴支	
植	木直	
纯	屯纟	
夏	夂𦣻	厦
忍	刃心	
页	页	题领须项预顿顾额顺顶页烦颗频颜颇颤顽颈颠硕颁颂颖颊顷颅嚣颓颐颌颉顼颍颚颔颧颏
杰	木灬	
筑	巩竹	
折	扌斤	哲誓逝浙蜇
郑	关阝	掷
贝	贝	员资则质费责财负货败贵赛购贸贝赞贫赏贴贯贡贷贺赔赋赢贪贤贼赌贾赐婴赠账赚贞贩贬贿贱坝贮赎狈赁赂赃贻赘赓钡贰赡呗赈罂赊赝贲
尊	寸酋	遵蹲樽
吴	口天	误娱虞蜈俣
秀	乃禾	透诱绣锈
混	昆氵	
臣	臣	臣卧宦臧
雅	牙隹	
振	扌辰	
染	木氿	
盛	成皿	
怒	奴心	
舞	一卌舛𠂉	
圆	员囗	
搞	扌高	
狂	犭王	逛诳
措	扌昔	
姓	女生	
残	戋歹	
秋	火禾	愁瞅揪啾锹鳅
培	咅土	
迷	米辶	谜
诚	成讠	
宽	宀苋	
宇	于宀	
猛	孟犭	
摆	扌罢	
梅	木每	
毁	殳𬛸	
伸	亻申	
摩	手麻	
盟	明皿	
末	末	末抹沫袜茉秣
乃	丿𠄎	仍秀奶扔孕氖隽艿鼐
悲	心非	
拍	扌白	啪
丁	一亅	可打顶宁灯订厅盯亭钉叮汀町酊仃
赵	㐅走	
硬	更石	
麦	夂龶	
蒋	将艹	
操	喿扌	
耶	耳阝	椰
阻	且阝	
订	丁讠	
彩	彡采	
抽	扌由	
赞	兟贝	攒瓒
魔	鬼麻	
纷	分纟	
沿	几口氵	
喊	口咸	
违	辶韦	
妹	女未	
浪	氵良	
汇	匚氵	
币	丿巾	
丰	三丨	拜邦寿艳彗蚌沣
蓝	监艹	
殊	朱歹	
献	南犬	
桌	⺊杲	
啦	口拉	
瓦	瓦	瓦瓶瓷瓮甄甑
莱	来艹	
援	扌爰	
译	讠𠬤	
夺	大寸	
汽	气氵	
烧	尧火	
距	巨𧾷	
裁	衣𢦏	
偏	亻扁	
符	付竹	
勇	力甬	
触	虫角	
课	果讠	
敬	攵苟	警擎儆
哭	吅犬	
懂	忄董	
墙	啬土	
袭	衣龙	
召	刀口	超招绍昭沼诏邵韶迢貂笤
罚	刂罒讠	
侠	亻夹	
厅	丁厂	
拜	一丰龵	湃
巧	丂工	窍
侧	亻则	
韩	韦𠦝	
冒	冃目	帽瑁勖
债	亻责	
曼	又日罒	慢漫蔓幔馒谩鳗
融	虫鬲	
惯	忄贯	
享	亠口子	敦郭醇淳孰谆鹑
戴	異𢦏	
童	立里	撞幢憧瞳潼僮
犹	尤犭	
乘	北禾	剩
挂	圭扌	
奖	丬夕大	
绍	召纟	
厚	㫗厂	
纵	从纟	
障	章阝	
讯	卂讠	
涉	步氵	
彻	切彳	
刊	刂干	
丈	丈	丈仗杖
爆	暴火	
乌	③一	呜坞钨
役	彳殳	
描	扌苗	
洗	先氵	
玛	王马	
患	串心	
妙	女少	
镜	竟钅	
唱	口昌	
烦	火页	
签	佥竹	
仙	亻山	
彼	彳皮	
弗	丨丿弓	费佛拂沸狒氟
症	正疒	
仿	亻方	
倾	亻顷	
牌	卑片	
陷	臽阝	
鸟	④一	鸡鸣鸿鹏鹰鸭鹅鸦鹤鸽莺鹃鸥鸠鹦鹊鹉鸳鸾鹳鸯鹞鹄鸵鹑鹫鹭鸬鹗鹌鹘鹬鸢茑鸨
轰	双车	
咱	口自	
菜	艹采	
闭	才门	
奋	大田	
庆	大广	
撤	扌攵育	
泪	氵目	
茶	人朩艹	搽
疾	疒矢	嫉
缘	彖纟	
播	扌番	
朗	⑤丶月	
杜	土木	
奶	乃女	
季	子禾	悸
丹	丹	丹坍彤
狗	句犭	
尾	尸毛	娓
仪	义亻	
偷	亻俞	
奔	卉大	
珠	朱王	
虫	虫	虽独触融虫蛋蛇蜂蜜蛮虹蝶螺蚁烛蜡蚀蛛蝇蚕虾蚂蛙蚊蝴浊蜘蝉蟹蝗闽蝠蛾萤蛟蠕螂茧蜕蜒蜷蟒蜗螅蛤蟋蟀蛊蝙蟆蜿蜈蝎蟾螃蚌蛹蛀蛔蚪蜻蚤蜓蚓蚣蝌蚯蛐蛰虬蛆蛭螳蟑蟠蟮蜃蜥蛳蚱蚜蝮蛎蚩蛉虻蜴蜚螨蜇蠼蜊蝈蚝蟪蚨蚴蛴蛞
驻	主马	
孔	乚子	吼
宜	且宀	谊
艾	乂艹	哎
桥	乔木	
淡	氵炎	
翼	異羽	
恨	忄艮	
繁	敏糸	
寒	⺀𡨄	
伴	亻半	
叹	又口	亟
旦	一日	但量查担坦胆昼袒暨亘靼疸妲
愈	俞心	
潮	朝氵	
粮	米良	
缩	宿纟	
罢	去罒	摆
聚	乑取	骤
径	彳𢀖	
恰	合忄	
挑	兆扌	
袋	代衣	
灰	火𠂇	恢炭盔诙
捕	扌甫	
徐	余彳	
珍	㐱王	
幕	巾莫	
映	央日	
裂	列衣	
泰	氺𡗗	傣
隔	阝鬲	
启	口户	
尖	大小	
忠	中心	
累	田糸	螺骡摞
炎	火	谈淡毯痰氮
暂	斩日	
估	亻古	
泛	乏氵	
荒	巟艹	慌谎
偿	亻尝	
横	木黄	
拒	巨扌	
瑞	王耑	
忆	乙忄	
孤	子瓜	
鼻	畀自	鼾
闹	市门	
羊	䒑丨二	着样群差善洋鲜详祥氧羞翔痒佯羌羚庠咩羯烊
呆	口木	保
厉	万厂	励蛎砺
衡	亍彳𩵋	
胞	包月	
零	令雨	
穷	力穴	
舍	人舌	舒啥
码	石马	
赫	赤	
婆	女波	
魂	云鬼	
灾	宀火	
洪	共氵	
腿	月退	
胆	旦月	
津	氵聿	
俗	亻谷	
辩	讠辛	
胸	匈月	
晓	尧日	
劲	力𢀖	
贫	分贝	
仁	二亻	
偶	亻禺	
辑	咠车	
邦	丰阝	帮绑梆
恢	忄灰	
赖	束负	懒籁濑癞獭
圈	卷囗	
摸	扌莫	
仰	亻卬	
润	氵闰	
堆	土隹	
碰	並石	
艇	廷舟	
稍	禾肖	
迟	尺辶	
辆	两车	
废	发广	
净	争冫	
凶	㐅凵	匈汹酗
署	罒者	薯曙
壁	土辟	
御	卸彳	
奉	丨二𡗗	棒捧俸
旋	方𭻾	璇漩
冬	⺀夂	图终疼咚佟
矿	广石	
抬	台扌	
蛋	疋虫	
晨	日辰	
伏	亻犬	袱茯
吹	口欠	
鸡	又鸟	
倍	亻咅	蓓
糊	米胡	
秦	禾𡗗	臻榛嗪
盾	𠂆𥃭	循遁
杯	不木	
租	且禾	
骑	奇马	
乏	丿之	泛眨贬砭
隆	㚅阝	窿
诊	㐱讠	
奴	又女	努怒弩呶
摄	扌聂	
丧	丷丿乀土𠄌	
污	亏氵	
渡	度氵	
旗	其方𠂉	
甘	甘	某甘甜钳酣邯柑苷
耐	寸而	
凭	任几	
扎	乚扌	
抢	仓扌	
绪	纟者	
粗	且米	
肩	户月	掮
梁	刅木氵	
幻	幺𠃌	
菲	艹非	
皆	比白	谐楷揩偕锴
碎	卒石	
宙	宀由	
叔	又尗	督寂淑椒
岩	山石	
荡	汤艹	
综	宗纟	
爬	巴爪	
荷	何艹	嗬
悉	心釆	蟋窸
蒂	帝艹	
返	反辶	
井	井	进讲井耕阱
壮	丬士	装
薄	溥艹	礴
悄	忄肖	
扫	彐扌	
敏	攵每	繁
碍	㝵石	
殖	歹直	
详	羊讠	
迪	由辶	
矛	丿龴𠄐	柔茅矜袤
霍	隹雨	
允	儿厶	吮
幅	巾畐	
撒	扌散	
剩	乘刂	
凯	几岂	
颗	果页	
骂	吅马	
赏	贝𫩠	
液	夜氵	
番	田釆	翻播潘幡蕃蟠燔鄱
箱	相竹	
贴	占贝	
漫	曼氵	
酸	夋酉	
郎	⑤丶阝	廊螂榔啷
腰	月要	
舒	予舍	
眉	目𠃜	媚湄嵋楣
忧	尤忄	
浮	孚氵	
辛	十立	辩辞辨薛宰辟辣辜瓣辫锌梓莘
恋	亦心	
餐	食𣦼	
吓	下口	
挺	廷扌	
励	力厉	
辞	舌辛	
艘	叟舟	
键	建钅	
伍	五亻	
峰	夆山	
尺	尺	尽迟尺昼咫
昨	乍日	
黎	人氺𥝢	藜
辈	车非	
贯	毌贝	惯
侦	亻贞	
滑	氵骨	
券	刀龹	
崇	宗山	
扰	尤扌	
宪	先宀	
绕	尧纟	
趋	刍走	
慈	兹心	
乔	丨丿夭	桥娇骄侨轿矫
阅	兑门	
汗	干氵	
枝	支木	
拖	㐌扌	
墨	土黑	
胁	办月	
插	扌臿	
箭	前竹	
腊	昔月	
粉	分米	
泥	尼氵	
氏	氏	纸氏昏衹舐氐芪
彭	壴彡	膨澎嘭
拔	扌犮	
骗	扁马	
凤	几又	
慧	彗心	
媒	女某	
佩	亻𫥞	
愤	忄贲	
扑	卜扌	
龄	令齿	
驱	区马	
惜	忄昔	
豪	亠冖口豕	壕嚎
掩	奄扌	
兼	④コ䒑一	廉嫌歉赚谦
跃	夭𧾷	
尸	尸	展局属尼居层户屋尾尸届屈卢履尿屏屠屁屡屑屉屎犀孱屐
肃	肃	肃萧啸箫
帕	巾白	
驶	史马	
堡	保土	
届	尸由	
欣	斤欠	掀锨
惠	⑧心	穗蕙蟪
册	册	册珊删栅姗跚
储	亻诸	
飘	票风	
桑	叒木	嗓搡
闲	木门	娴痫
惨	参忄	
洁	吉氵	
踪	宗𧾷	
勃	力孛	渤
宾	兵宀	滨鬓缤殡嫔槟摈膑
频	步页	濒颦
仇	九亻	
磨	石麻	蘑
递	弟辶	
邪	牙阝	
撞	扌童	
拟	以扌	
滚	氵衮	
奏	天𡗗	凑揍辏
巡	巛辶	
颜	彦页	
剂	刂齐	
绩	纟责	
贡	工贝	赣
疯	疒风	
坡	土皮	
瞧	焦目	
截	隹𢦏	
燃	火然	
焦	灬隹	瞧礁蕉樵憔醮
殿	殳𡱒	臀癜
伪	为亻	
柳	卯木	
锁	钅𭕆	
逼	畐辶	
颇	皮页	
昏	日氏	婚
劝	力又	
呈	口王	程逞郢锃
搜	叟扌	
勤	力堇	
戒	廾戈	械诫
驾	加马	
漂	氵票	
饮	欠饣	
曹	一日曲	遭糟槽嘈漕
朵	几木	躲跺垛剁
仔	亻子	
柔	木矛	揉蹂
俩	两亻	
孟	子皿	猛锰
腐	府肉	
幼	力幺	黝拗坳窈蚴
践	戋𧾷	
籍	竹耤	
牧	攵牛	
凉	京冫	
牲	牛生	
佳	亻圭	
娜	女那	
浓	农氵	
芳	方艹	
稿	禾高	
竹	亇	第等管笑算答策简笔篇筑符签箱箭籍筹笼筒筋笨篮笛篷簿簇竿筷篱笃笠簧筛筐筝竺笋簸笆箫笈笺箍筏箓筵笙簌篓筱籁篆箴簪篝箕簦箔箩筠笞篙笥笏笕篾笫竽笤
腹	复月	
跌	失𧾷	
逻	罗辶	
垂	⑥一丿	睡锤唾捶陲
遵	尊辶	
脉	月永	
貌	皃豸	藐邈
柏	木白	
狱	犬犭讠	
猜	犭青	
怜	令忄	
惑	心或	
陶	匋阝	
兽	一口𬎿	
帐	巾长	
饰	巾饣𠂉	
贷	代贝	
昌	日	唱倡猖娼
叙	余又	
躺	尚身	
钢	冈钅	
沟	勾氵	
寄	奇宀	
扶	夫扌	
铺	甫钅	
邓	又阝	
寿	丰寸	筹涛祷铸畴焘踌俦
惧	具忄	
询	旬讠	
汤	氵𠃓	荡烫
盗	次皿	
肥	巴月	
尝	云龸	偿
匆	丶勿	
辉	光军	
奈	大示	捺
扣	口扌	
廷	壬廴	庭艇挺霆蜓铤
澳	奥氵	
嘛	口麻	
董	艹重	懂
迁	千辶	
凝	冫疑	
慰	尉心	
厌	厂犬	魇靥
脏	庄月	
腾	月马龹	
幽	山𢆶	
怨	夗心	
鞋	圭革	
丢	丿去	
埋	土里	
泉	水白	腺
涌	氵甬	
辖	害车	
躲	朵身	
晋	亚日	缙
紫	此糸	
艰	又艮	
魏	委鬼	巍
吾	五口	语悟晤衙捂唔梧龉
慌	忄荒	
祝	兄礻	
邮	由阝	
吐	口土	
狠	犭艮	
鉴	〢丶金𠂉	
曰	曰	曰汩
械	戒木	
咬	交口	
邻	令阝	
赤	④土	赫郝赦哧赭
挤	扌齐	
弯	亦弓	湾
椅	奇木	
陪	咅阝	
割	刂害	
揭	扌曷	
韦	韦	围伟违韩韦纬讳韧苇韬闱炜
悟	吾忄	
聪	总耳	
雾	务雨	
锋	夆钅	
梯	弟木	
猫	犭苗	
祥	礻羊	
阔	活门	
誉	兴言	
筹	寿竹	
丛	一从	
牵	冖大牛	
鸣	口鸟	
沈	冘氵	
阁	各门	搁
穆	㣎禾	
屈	出尸	掘窟崛倔
旨	匕日	指脂稽诣酯
袖	由衤	
猎	昔犭	
臂	月辟	
蛇	它虫	
贺	加贝	
柱	主木	
抛	扌𠠵	
鼠	⑦臼	鼹
瑟	必玨	
戈	丿弋	战或找划戏戒伐戳戎戮戟畿戛戡戕
牢	宀牛	
逊	孙辶	
迈	万辶	
欺	其欠	
吨	口屯	
琴	今玨	
衰	一亠口𧘇	蓑
瓶	并瓦	
恼	㐫忄	
燕	北口廿灬	
仲	中亻	
诱	秀讠	
狼	犭良	
池	也氵	
疼	冬疒	
卢	⺊尸	颅鲈鸬胪泸
仗	丈亻	
冠	㝴冖	
粒	立米	
遥	䍃辶	
吕	口	营宫串侣铝闾
玄	亠幺	率畜弦眩舷炫铉
尘	土小	
冯	冫马	
抚	扌无	
浅	戋氵	
敦	享攵	墩
纠	丩纟	
钻	占钅	
晶	日昍	
岂	山己	凯恺皑铠觊闿
峡	夹山	
苍	仓艹	
喷	口贲	
耗	毛耒	
凌	冫夌	
敲	攴高	
菌	囷艹	
赔	咅贝	
涂	余氵	
粹	卒米	
扁	户𠕁	编篇遍偏骗翩匾蝙谝
亏	一丂	污夸
寂	叔宀	
煤	某火	
熊	灬能	
恭	㣺共	
湿	显氵	
循	彳盾	
暖	日爰	
糖	唐米	
赋	武贝	
抑	卬扌	
秩	失禾	
帽	冒巾	
哀	亠口𧘇	
宿	佰宀	缩蓿
踏	沓𧾷	
烂	兰火	
袁	𠮷𧘇	猿辕
侯	ユ亻矢	喉猴
抖	扌斗	
夹	丷夫	侠峡狭陕颊挟惬荚郏浃
昆	日比	混棍琨馄锟
肝	干月	
擦	察扌	
猪	犭者	
炼	火𫠣	
恒	亘忄	
慎	忄真	
搬	扌般	
纽	丑纟	
纹	文纟	
玻	王皮	
渔	氵鱼	
磁	兹石	
铜	同钅	
齿	齿	龄齿龋龈啮龊龌龇龅龉
跨	夸𧾷	
押	扌甲	
怖	布忄	
漠	氵莫	
疲	疒皮	
叛	半反	
遣	辶𠳋	谴
兹	䒑𢆶	慈磁滋孳
祭	②冫示𠂊	察蔡
醉	卒酉	
拳	手龹	
弥	尔弓	猕
斜	余斗	
档	当木	
稀	希禾	
捷	扌疌	
肤	夫月	
疫	殳疒	
肿	中月	
豆	豆	登短豆逗痘豌壹
削	刂肖	
岗	冈山	
晃	光日	幌
吞	口天	
宏	厷宀	
癌	嵒疒	
肚	土月	
隶	隶	康隶逮棣
履	尸復	
涨	张氵	
耀	光翟	
扭	丑扌	
坛	云土	
拨	发扌	
沃	夭氵	鋈
绘	会纟	
伐	亻戈	阀筏
堪	土甚	
仆	亻卜	
郭	享阝	廓
牺	牛西	
歼	千歹	
墓	土莫	
雇	户隹	
廉	兼广	镰濂
契	㓞大	楔锲
拼	并扌	
惩	征心	
捉	扌足	
覆	復覀	
刷	刂𡰯	唰涮
劫	力去	
嫌	兼女	
瓜	瓜	孤瓜狐瓣弧呱瓢
歇	曷欠	
雕	周隹	
闷	心门	
乳	乚孚	
串	丨吕	患窜
娃	圭女	
缴	敫纟	
唤	口奂	
赢	凡吂月贝	
莲	艹连	
霸	䩗雨	
桃	兆木	
妥	女爫	绥馁
瘦	叟疒	
搭	扌荅	
赴	卜走	
岳	丘山	
嘉	加壴	
舱	仓舟	
俊	亻夋	
址	土止	
庞	广龙	
耕	井耒	
锐	兑钅	
缝	纟逢	
悔	忄每	
邀	敫辶	
玲	令王	
惟	忄隹	罹
斥	丶斤	诉拆
宅	乇宀	诧咤
添	忝氵	
挖	扌穵	
呵	口可	
讼	公讠	
氧	气羊	
浩	告氵	
羽	习	翻翼翰扇翅翁翠翔翘翩翎翌栩诩翟翡翱翊翦羿翳
斤	丅𠂆	所新斯听近断析折欣斥匠祈斩斧芹沂靳忻斫昕圻
酷	告酉	
掠	京扌	
妖	夭女	
祸	呙礻	
侍	亻寺	
乙	乙	艺亿忆乙乞
妨	女方	
贪	今贝	
挣	争扌	
汪	氵王	
尿	尸水	
莉	利艹	
悬	县心	
唇	口辰	
翰	人羽𠦝	瀚
仓	㔾人	创枪抢苍舱沧疮跄呛瘪怆
轨	九车	匦
枚	攵木	
盐	圤皿	
览	〢丶见𠂉	揽缆榄
傅	亻尃	
帅	丨丿巾	
庙	广由	
芬	分艹	
屏	尸并	摒
寺	土寸	等特持待诗侍峙恃痔
胖	半月	
璃	王离	
愚	心禺	
滴	啇氵	
疏	㐬𤴔	蔬
萧	肃艹	潇
姿	女次	
颤	亶页	
丑	丑	纽扭丑羞钮妞忸
劣	力少	
柯	可木	
寸	寸	时对过导射村守付讨封寻尊夺耐寿寺寸辱尉衬忖肘纣
扔	乃扌	
盯	丁目	
辱	寸辰	褥耨
匹	儿匚	甚
俱	亻具	
辨	②辛	
饿	我饣	
蜂	夆虫	
哦	口我	
腔	月空	
郁	有阝	
溃	氵贵	
谨	堇讠	
糟	曹米	
葛	曷艹	噶
苗	田艹	描猫瞄锚喵
肠	月𠃓	
忌	己心	
溜	氵留	
鸿	江鸟	
爵	爫罒𡬠	嚼
鹏	朋鸟	
鹰	䧹鸟	
笼	竹龙	
丘	丘	兵岳丘邱乒乓蚯
桂	圭木	
滋	兹氵	
聊	卯耳	
挡	当扌	
纲	冈纟	
肌	几月	
茨	次艹	
壳	冗士	
痕	疒艮	
碗	宛石	
穴	八宀	空究突穿窗穷窝窃窄窑帘窜窥窦窟窘窍窒窖穹窿邃窠窈窕窣窸
膀	旁月	
卓	⺊早	掉罩绰悼淖
贤	〢又贝	
卧	卜臣	
膜	月莫	
毅	殳豙	
锦	帛钅	
欠	欠	次欢款欧歌软欲吹欣饮欺歇欠钦歉砍坎炊欤歆歙
哩	口里	
函	丷了八凵	涵
茫	汒艹	
昂	卬日	
薛	艹辛𠂤	孽
皱	刍皮	
夸	亏大	跨垮挎胯
豫	予象	
胃	月田	谓渭喟猬
舌	千口	话活敌适乱括舍辞甜刮舔恬舐憩蛞
剥	刂录	
傲	亻敖	
拾	合扌	
窝	呙穴	
睁	争目	
携	扌隽	
陵	夌阝	
哼	亨口	
棉	帛木	
晴	日青	
铃	令钅	
填	土真	
饲	司饣	
渴	曷氵	
吻	勿口	
扮	分扌	
逆	屰辶	
脆	危月	
喘	口耑	
罩	卓罒	
卜	卜	下外处卡补扑仆赴卧卜朴卦讣
炉	户火	
柴	木此	
愉	俞忄	
绳	纟黾	
胎	台月	
蓄	畜艹	
眠	民目	
竭	曷立	
喂	口畏	
傻	亻𡕩	
慕	㣺莫	
浑	军氵	
奸	女干	
扇	户羽	煽
柜	巨木	
悦	兑忄	
拦	兰扌	
诞	延讠	
饱	包饣	
乾	乞𠦝	
泡	包氵	
贼	戎贝	
亭	丁亠冖口	停婷
夕	丶𠂊	多外名罗岁梦奖浆歹桨酱汐飧舛
爹	多父	嗲
酬	州酉	
儒	亻需	
姻	因女	
卵	卪𠂑	孵
氛	分气	
泄	世氵	
杆	干木	
挨	扌矣	
僧	亻曾	
蜜	宓虫	
吟	今口	
猩	星犭	
遂	㒸辶	隧燧
狭	夹犭	
肖	⺌月	消销稍悄削哨屑梢俏峭鞘硝霄宵逍捎诮艄
甜	甘舌	
霞	叚雨	
驳	爻马	
裕	衤谷	
顽	元页	
於	仒方	淤瘀
摘	啇扌	
矮	委矢	
秒	少禾	
卿	⑤卩𠂎	
畜	玄田	蓄搐
咽	口因	
披	扌皮	
辅	甫车	
勾	勹厶	构购沟钩
盆	分皿	
疆	土弓畺	
赌	者贝	
塑	土朔	
畏	一丿乀田𠄌	喂偎猥煨
吵	口少	
囊	一中冖吅𠀎𧘇	囔馕
嗯	口恩	
泊	氵白	箔
肺	巿月	
骤	聚马	
缠	㢆纟	
冈	㐅冂	刚钢岗纲
羞	丑羊	馐
瞪	登目	
吊	口巾	
贾	覀贝	
漏	屚氵	
斑	文王	
涛	寿氵	
悠	心攸	
鹿	コ丨广比	麟麓漉辘麝麋麒麂鏖
俘	亻孚	
锡	易钅	
卑	丿十白	牌碑脾啤婢俾裨颦稗
葬	廾死艹	
铭	名钅	
滩	氵难	
嫁	女家	
催	亻崔	
璇	旋王	
翅	支羽	
盒	合皿	
蛮	亦虫	
矣	厶矢	埃挨唉俟
潘	氵番	藩
歧	支止	
赐	易贝	
鲍	包鱼	
锅	呙钅	
廊	广郎	
拆	扌斥	
灌	氵雚	
勉	免力	
盲	亡目	
宰	宀辛	滓
佐	亻左	
啥	口舍	
胀	月长	
扯	扌止	
禧	喜礻	
辽	了辶	
抹	扌末	
筒	同竹	
棋	其木	
裤	库衤	
唉	口矣	
朴	卜木	
咐	付口	
孕	乃子	
誓	折言	
喉	侯口	
妄	亡女	
拘	句扌	
链	连钅	
驰	也马	
栏	兰木	
逝	折辶	
窃	切穴	
艳	丰色	
臭	犬自	嗅溴
纤	千纟	
玑	几王	
棵	木果	
趁	㐱走	
匠	匚斤	
盈	夃皿	楹
翁	公羽	嗡
愁	心秋	
瞬	目舜	
婴	女贝	樱鹦缨嘤
孝	子耂	教哮酵
颈	页𢀖	
倘	亻尚	
浙	折氵	
谅	京讠	
蔽	敝艹	
畅	申𠃓	
赠	曾贝	
妮	女尼	
莎	沙艹	
尉	寸𫵖	慰蔚熨
冻	东冫	
跪	危𧾷	
闯	门马	
葡	匍艹	
後	夂幺彳	
厨	厂𭔰	橱
鸭	甲鸟	
颠	真页	癫巅
遮	庶辶	
谊	宜讠	
圳	土川	
吁	于口	
仑	人匕	论伦轮沦纶抡
辟	辛𡰪	避壁臂譬劈僻霹璧癖噼
瘤	留疒	
嫂	叟女	
陀	它阝	
框	匡木	
谭	覃讠	
亨	了亠口	哼烹
钦	欠钅	揿
庸	广𬎾	慵
歉	兼欠	
芝	之艹	
吼	口孔	
甫	丶十月	捕铺辅浦哺脯埔圃匍莆補
衫	彡衤	
摊	扌难	
宴	妟宀	
嘱	口属	
衷	中亠𧘇	
娇	乔女	
陕	夹阝	
矩	巨矢	榘
浦	氵甫	蒲
讶	牙讠	
耸	从耳	
裸	果衤	
碧	珀石	
摧	崔扌	
薪	新艹	
淋	林氵	
耻	止耳	
胶	交月	
屠	尸者	
鹅	我鸟	
饥	几饣	
盼	分目	
脖	孛月	
虹	工虫	
翠	卒羽	
崩	山朋	蹦
账	贝长	
萍	泙艹	
逢	夆辶	缝蓬篷
赚	兼贝	
撑	扌掌	
翔	羊羽	
倡	亻昌	
绵	帛纟	
猴	侯犭	
枯	古木	
巫	从工	诬
昭	召日	照
怔	忄正	
渊	氵𫂱	
凑	冫奏	
溪	奚氵	
蠢	䖵春	
禅	单礻	
阐	单门	
旺	日王	
寓	宀禺	
藤	滕艹	
匪	匚非	
伞	丷人十	
碑	卑石	
挪	扌那	
琼	京王	
脂	旨月	
谎	荒讠	
慨	忄既	
菩	咅艹	
萄	匋艹	
狮	师犭	
掘	屈扌	
抄	少扌	
岭	令山	
晕	军日	
逮	辶隶	
砍	欠石	
掏	匋扌	
狄	火犭	荻
晰	日析	
罕	㓁干	
挽	免扌	
脾	卑月	
舟	舟	船般航舰盘艇艘舱舟舶舵舷舫艄舸
痴	疒知	
蔡	祭艹	
剪	刀前	
脊	丷人八月	瘠
弓	弓	强张引弹弱弗弯弥疆弓弦夷弘躬粥弧弛弩穹弼弭
懒	忄赖	
叉	丶又	钗蚤杈衩
拐	另扌	
喃	南口	
僚	亻尞	
捐	扌肙	
姊	女𠂔	
骚	蚤马	
拓	扌石	
歪	不正	
粘	占米	
柄	丙木	
坑	亢土	
陌	百阝	
窄	乍穴	榨
湘	氵相	
兆	兆	逃跳挑桃兆姚眺晁窕
崖	厓山	
骄	乔马	
刹	刂杀	
鞭	便革	
芒	亡艹	
筋	竹肋	
聘	甹耳	
钩	勾钅	
棍	昆木	
嚷	口襄	
腺	月泉	
弦	弓玄	
焰	火臽	
耍	女而	
俯	亻府	
厘	厂里	
愣	忄𬙙	
厦	厂夏	
恳	心艮	
饶	尧饣	
钉	丁钅	
寡	丆且分宀	
憾	忄感	
摔	扌率	
叠	冝叒	
惹	心若	
喻	俞口	
谱	普讠	
愧	忄鬼	
煌	火皇	
徽	彳𢾰	
溶	容氵	
坠	土队	
煞	灬𭣦	
巾	巾	常市带布帝帮席币幕幅帕帐饰帽帅吊巾帘帆幢帜帖幌幡帷幔帧帚帛匝帼幄
滥	氵监	
洒	氵西	
堵	土者	
瓷	次瓦	
咒	几吅	
姨	夷女	
棒	奉木	
郡	君阝	
浴	氵谷	
媚	女眉	
稣	禾鱼	
淮	氵隹	
哎	口艾	
屁	尸比	
漆	桼氵	
淫	㸒氵	
巢	巛果	剿缫
吩	分口	
撰	巽扌	
啸	口肃	
滞	带氵	
玫	攵王	
硕	石页	
钓	勺钅	
蝶	枼虫	
膝	月桼	
姚	兆女	
茂	戊艹	
躯	区身	
吏	一史	使
猿	犭袁	
寨	木𡨄	
恕	如心	
渠	木洰	
戚	尗戊	蹙嘁槭
辰	丿乀二厂𠄌	震振晨唇辱娠赈蜃宸
舶	白舟	
颁	分页	
惶	忄皇	
狐	犭瓜	
讽	讠风	
笨	本竹	
袍	包衤	
嘲	口朝	
啡	口非	
泼	发氵	
衔	亍彳钅	
倦	亻卷	
涵	函氵	
雀	小隹	
旬	勹日	询殉荀绚徇洵峋
僵	亻畺	
撕	扌斯	
肢	支月	
垄	土龙	
夷	大弓	姨咦胰
逸	兔辶	
茅	矛艹	
侨	乔亻	
舆	一八车𦥑	
窑	穴缶	
涅	圼氵	
蒲	浦艹	
谦	兼讠	
杭	亢木	
噢	口奥	
弊	廾敝	
勋	力员	
刮	刂舌	
郊	交阝	
凄	冫妻	
捧	奉扌	
浸	氵𠬶	
砖	专石	
鼎	⑧目	鼐
篮	监竹	
蒸	烝艹	
饼	并饣	
亩	亠田	
肾	〢又月	
陡	走阝	
爪	爪	抓爬爪
兔	丶免	逸冤
殷	㐆殳	
贞	⺊贝	侦帧桢祯
荐	存艹	鞯
哑	亚口	
炭	山灰	碳
坟	土文	
眨	乏目	
搏	尃扌	
咳	亥口	
拢	扌龙	
舅	男臼	
昧	日未	
擅	亶扌	
爽	㸚大	
咖	加口	
搁	扌阁	
禄	录礻	
雌	此隹	
哨	口肖	
巩	凡工	恐筑
绢	纟肙	
螺	累虫	
裹	亠果𧘇	
昔	日龷	错借措腊惜猎蜡醋鹊厝
轩	干车	
谬	翏讠	
谍	枼讠	
龟	乚日𠂊	阄
媳	女息	
姜	女𦍌	
瞎	害目	
冤	兔冖	
鸦	牙鸟	
蓬	艹逢	
巷	共巳	港
琳	林王	
栽	木𢦏	
沾	占氵	
诈	乍讠	
斋	文而	
瞒	目𬜯	
彪	彡虎	
厄	㔾厂	顾扼呃轭
咨	口次	谘
纺	方纟	
罐	缶雚	
桶	木甬	
壤	土襄	
糕	米羔	
颂	公页	
膨	彭月	
谐	皆讠	
垒	厽土	
咕	口古	
隙	阝𡭴	
辣	束辛	
绑	纟邦	
宠	宀龙	
嘿	口黑	
兑	丷兄	说税脱阅锐悦蜕
霉	每雨	
挫	坐扌	
稽	尤旨禾	
辐	畐车	
乞	乙𠂉	吃乾迄疙屹圪讫纥
纱	少纟	
裙	君衤	
嘻	口喜	
哇	口圭	
绣	秀纟	
杖	丈木	
塘	唐土	
衍	亍彳氵	
轴	由车	
攀	手樊	
膊	尃月	
譬	言辟	
斌	文武	
祈	斤礻	
踢	易𧾷	
肆	聿镸	
坎	土欠	
轿	乔车	
棚	朋木	
泣	氵立	
屡	娄尸	
躁	喿𧾷	
邱	丘阝	
凰	几皇	
溢	氵益	
椎	木隹	
砸	匝石	
趟	尚走	
帘	巾穴	
帆	凡巾	
栖	木西	
窜	串穴	蹿
丸	丶九	执孰
斩	斤车	渐暂惭崭堑錾
堤	土是	
塌	土𦐇	
贩	反贝	
厢	厂相	
掀	扌欣	
喀	口客	
乖	北千	
谜	讠迷	
捏	圼扌	
阎	臽门	
滨	宾氵	
虏	力虍	掳
匙	匕是	
芦	户艹	
苹	平艹	
卸	卩𦈢	御
沼	召氵	
钥	月钅	
株	木朱	
祷	寿礻	
剖	刂咅	
熙	巸灬	
哗	华口	
劈	刀辟	
怯	去忄	
棠	木𫩠	
胳	各月	
桩	庄木	
瑰	王鬼	
娱	吴女	
娶	取女	
沫	末氵	
嗓	口桑	
蹲	尊𧾷	
焚	林火	
淘	匋氵	
嫩	女敕	
韵	匀音	
衬	寸衤	
匈	凶勹	胸
钧	匀钅	
竖	〢又立	
峻	夋山	
豹	勺豸	
捞	劳扌	
菊	匊艹	
鄙	啚阝	
魄	白鬼	
兜	②コ儿白	
哄	共口	
颖	匕禾页	
镑	旁钅	
屑	尸肖	
蚁	义虫	
壶	业冖士	
怡	台忄	
渗	参氵	
秃	几禾	颓
迦	加辶	
旱	干日	悍捍焊
哟	口约	
咸	口戌	感减喊碱缄箴
焉	②正灬	嫣蔫
谴	讠遣	
宛	夗宀	碗腕婉惋蜿畹豌琬剜
稻	禾舀	
铸	寿钅	
锻	段钅	
伽	亻加	
詹	儿厃言	瞻檐赡蟾澹
毙	死比	
恍	光忄	
贬	乏贝	
烛	火虫	
骇	亥马	
芯	心艹	
汁	十氵	
桓	亘木	
坊	土方	
驴	户马	
朽	丂木	
靖	立青	
佣	亻用	
汝	女氵	
碌	录石	
迄	乞辶	
冀	北異	骥
荆	刂茾	
崔	山隹	催摧璀
雁	倠厂	赝
绅	申纟	
珊	册王	
榜	旁木	
诵	甬讠	
傍	亻旁	
彦	产彡	颜谚
醇	享酉	
笛	由竹	
禽	人离	擒噙
勿	丿勹	物易忽匆吻笏
娟	女肙	
瞄	目苗	
幢	巾童	
寇	元宀攴	
睹	目者	
贿	有贝	
踩	采𧾷	
霆	廷雨	
呜	乌口	
拱	共扌	
妃	女己	
蔑	戍𦭝	
谕	俞讠	
缚	尃纟	
诡	危讠	
篷	竹逢	
淹	奄氵	
腕	宛月	
煮	灬者	
倩	亻青	
卒	十𠅃	碎粹醉翠猝悴萃瘁啐窣淬
勘	力甚	
馨	殸香	
逗	豆辶	
甸	勹田	
贱	戋贝	溅
炒	少火	
灿	山火	
敞	尚攵	
蜡	昔虫	
囚	人囗	泅
栗	木覀	
辜	古辛	
垫	土执	
妒	女户	
魁	斗鬼	
谣	䍃讠	
寞	宀莫	
蜀	罒𠣜	镯
甩	乚二冂	
涯	厓氵	
枕	冘木	
丐	丐	丐钙
泳	氵永	
奎	圭大	
泌	必氵	
逾	俞辶	
叮	丁口	
黛	代黑	
燥	喿火	
掷	扌郑	
藉	耤艹	
枢	区木	
憎	忄曾	
鲸	京鱼	
弘	厶弓	泓
倚	亻奇	
侮	亻每	
藩	潘艹	
拂	弗扌	
鹤	隺鸟	
蚀	虫饣	
浆	丬夕水	
芙	夫艹	
垃	土立	
烤	火考	
晒	日西	
霜	相雨	孀
剿	刂巢	
蕴	缊艹	
圾	及土	
绸	周纟	
屿	与山	
氢	气𢀖	
驼	它马	
妆	丬女	
捆	困扌	
铅	口钅𠘧	
逛	狂辶	
淑	叔氵	
榴	木留	
丙	一内	病柄炳
痒	疒羊	
钞	少钅	
蹄	帝𧾷	
犬	犬	然器突状默献哭伏狱厌臭犬倏吠戾猷
躬	弓身	
昼	尺旦	
藻	澡艹	
蛛	朱虫	
褐	曷衤	
颊	夹页	
奠	大酋	
募	力莫	
耽	冘耳	
蹈	舀𧾷	
陋	阝𫠥	
侣	亻吕	
魅	未鬼	
岚	山风	
侄	亻至	
虐	一匚虍	谑
堕	土陏	
陛	坒阝	
莹	玉𫇦	滢
荫	艹阴	
狡	交犭	
阀	伐门	
绞	交纟	
膏	月高	
垮	土夸	
茎	艹𢀖	
缅	纟面	
喇	剌口	
绒	戎纟	
搅	扌觉	
凳	几登	
梭	夋木	
丫	丨丷	
姬	女𦣞	
诏	召讠	
钮	丑钅	
棺	官木	
耿	火耳	
缔	帝纟	
懈	忄解	
嫉	女疾	
灶	土火	
匀	冫勹	均韵钧
嗣	口司𠕁	
鸽	合鸟	
澡	喿氵	藻
凿	丵凵	
纬	纟韦	
沸	弗氵	
畴	寿田	
刃	丿刀	忍涩韧纫
遏	曷辶	
烁	乐火	
嗅	口臭	
叭	八口	
熬	敖灬	
瞥	敝目	
骸	亥骨	
奢	大者	
拙	出扌	
栋	东木	
毯	毛炎	
桐	同木	
砂	少石	
莽	廾𦬫	蟒
泻	写氵	
坪	土平	
梳	㐬木	
杉	彡木	
晤	吾日	
稚	禾隹	
蔬	疏艹	
蝇	虫黾	
捣	岛扌	
顷	匕页	倾
麽	么麻	嬷
尴	尢监	
镖	票钅	
诧	宅讠	
尬	介尢	
硫	㐬石	
嚼	口爵	
羡	次𦍌	
沦	仑氵	
沪	户氵	
旷	广日	
彬	彡林	
芽	牙艹	
狸	犭里	
冥	冖昗	瞑溟
碳	炭石	
咧	列口	
惕	忄易	
暑	日者	
咯	口各	
萝	罗艹	
汹	凶氵	
腥	星月	
窥	穴规	
俺	亻奄	
潭	氵覃	
崎	奇山	
麟	粦鹿	
捡	佥扌	
拯	丞扌	
厥	厂欮	獗撅蕨蹶噘橛
澄	氵登	
萎	委艹	
哉	口𢦏	
涡	呙氵	
滔	氵舀	
暇	叚日	
溯	朔氵	
鳞	粦鱼	
酿	良酉	
茵	因艹	
愕	咢忄	
瞅	目秋	
暮	日莫	
衙	亍吾彳	
诫	戒讠	
斧	斤父	
兮	丂八	
焕	奂火	
棕	宗木	
佑	亻右	
嘶	口斯	
妓	女支	
喧	口宣	
蓉	容艹	
删	册刂	
樱	婴木	
伺	亻司	
嗡	口翁	
娥	女我	
梢	木肖	
坝	土贝	
蚕	天虫	
敷	攵旉	
澜	氵阑	
杏	口木	
绥	妥纟	
冶	冫台	
庇	广比	
挠	尧扌	
搂	娄扌	
倏	丨亻夂犬	
聂	双耳	摄慑蹑嗫
婉	女宛	
噪	口喿	
稼	家禾	
鳍	耆鱼	
菱	夌艹	
盏	戋皿	
匿	匚若	
吱	口支	
寝	丬宀𠬶	
揽	扌览	
髓	遀骨	
秉	コ一禾	
哺	口甫	
矢	大𠂉	知候医族短疾侯矮矣矩矫雉
啪	口拍	
帜	只巾	
邵	召阝	
嗽	口欶	
挟	夹扌	
缸	工缶	
揉	扌柔	
腻	月贰	
驯	川马	
缆	纟览	
晌	向日	
瘫	疒难	
贮	㝉贝	
觅	爫见	
朦	月蒙	
僻	亻辟	
隋	左月阝	
蔓	曼艹	
咋	乍口	
嵌	山𣢟	
虔	文虍	
畔	半田	
琐	王𭕆	
碟	枼石	
涩	刃止氵	
胧	月龙	
嘟	口都	
蹦	崩𧾷	
冢	冖豖	
浏	刂汶	
裔	冏衣	
襟	禁衤	
叨	刀口	
诀	夬讠	
旭	九日	
虾	下虫	
簿	溥竹	
啤	卑口	
擒	扌禽	
枣	⺀朿	
嘎	口戛	
苑	夗艹	
牟	厶牛	眸
呕	区口	
骆	各马	
凸	凸	凸
熄	息火	
兀	一儿	光元尧髡
喔	口屋	
裳	衣𫩠	
凹	凹	凹
赎	卖贝	
屯	丿𡳾	顿纯吨钝沌炖盹饨囤
膛	堂月	
浇	尧氵	
灼	勺火	
裘	求衣	
砰	平石	
棘	朿	
橡	木象	
碱	咸石	
聋	耳龙	
姥	女老	
瑜	俞王	
毋	毋	毋
娅	亚女	
沮	且氵	
萌	明艹	
俏	亻肖	
黯	音黑	
撇	扌敝	
粟	米覀	
粪	共米	
尹	コ一丿	伊君笋
苟	句艹	敬
癫	疒颠	
蚂	虫马	
禹	禹	属禹龋
廖	广翏	
俭	亻佥	
帖	占巾	
煎	前灬	
缕	娄纟	
窦	卖穴	
簇	族竹	
棱	夌木	
叩	卩口	命
呐	内口	
瑶	䍃王	
墅	土野	
莺	鸟𫇦	
烫	汤火	
蛙	圭虫	
歹	一夕	死列残殊殖歼殆殉殃殡夙殁殓殒
伶	亻令	
葱	怱艹	
哮	口孝	
眩	玄目	
坤	土申	
廓	广郭	
讳	讠韦	
啼	口帝	
乍	乍	作怎炸昨窄诈咋乍蚱酢祚
瓣	瓜辛	
矫	乔矢	
跋	犮𧾷	
枉	木王	
梗	更木	
厕	则厂	
琢	王豖	
讥	几讠	
釉	由釆	
窟	屈穴	
敛	佥攵	
轼	式车	
庐	广户	
胚	丕月	
呻	口申	
绰	卓纟	
扼	厄扌	
懿	壹恣	
炯	冋火	
竿	干竹	
慷	康忄	
虞	吴虍	
锤	垂钅	
栓	全木	
桨	丬夕木	
蚊	文虫	
磅	旁石	
孽	子薛	
惭	忄斩	
戳	戈翟	
禀	㐭示	凛懔
鄂	咢阝	
馈	贵饣	
垣	亘土	
溅	氵贱	
咚	冬口	
钙	丐钅	
礁	焦石	
彰	彡章	
豁	害谷	
眯	目米	
磷	石粦	
雯	文雨	
墟	土虚	
迂	于辶	
瞻	目詹	
颅	卢页	
琉	㐬王	
悼	卓忄	
蝴	胡虫	
拣	扌𫠣	
渺	氵眇	
眷	目龹	
悯	忄闵	
汰	太氵	
慑	忄聂	
婶	女审	
斐	文非	
嘘	口虚	
镶	襄钅	
炕	亢火	
宦	宀臣	
趴	八𧾷	
绷	朋纟	
窘	君穴	
襄	亠吅𠀎𧘇	嚷壤镶攘骧
珀	王白	碧
嚣	吅页	
拚	弁扌	
酌	勺酉	
浊	氵虫	
毓	㐬每	
撼	感扌	
嗜	口耆	
扛	工扌	
峭	山肖	
磕	盍石	
翘	尧羽	
槽	曹木	
淌	尚氵	
栅	册木	
颓	秃页	
熏	熏	熏薰醺
瑛	王英	
颐	页𦣞	
忖	寸忄	
牡	土牛	
缀	叕纟	
徊	回彳	
梨	利木	
肪	方月	
涕	弟氵	
惫	夂思	
摹	手莫	
踱	度𧾷	
肘	寸月	
熔	容火	
挚	手执	
氯	录气	
凛	冫禀	
绎	纟𠬤	
庶	广廿灬	遮蔗
脯	月甫	
迭	失辶	
睦	坴目	
窍	巧穴	
粥	弓米	
庵	奄广	
沧	仓氵	
怠	台心	
沁	心氵	
奕	亦大	
咙	口龙	
氨	安气	
矗	直	
盔	灰皿	
拇	扌母	
沛	巿氵	
榻	木𦐇	
揣	扌耑	
崭	山斩	
鞘	肖革	
鞠	匊革	
垦	土艮	
洽	合氵	
唾	口垂	
橱	厨木	
仕	亻士	
蜘	知虫	
痰	炎疒	
袜	末衤	
峙	寺山	
柬	柬	柬谏阑
蝉	单虫	
蟹	虫解	
谏	柬讠	
鹃	肙鸟	
擎	手敬	
皓	告白	
朕	关月	
疤	巴疒	
禺	禺	遇偶愚寓禺隅耦
铲	产钅	
酶	每酉	
钝	屯钅	
氓	亡民	
匣	匚甲	
弧	弓瓜	
峨	山我	
锥	钅隹	
揪	扌秋	
杠	工木	
吭	亢口	
崛	屈山	
诬	巫讠	
冉	冉	再冉髯
抒	予扌	
庚	コ一人广	赓
悍	忄旱	
靡	非麻	
晦	日每	
醋	昔酉	
壕	土豪	
锯	居钅	
夭	丿大	笑乔跃沃妖袄
咦	口夷	
侈	亻多	
婢	卑女	
猾	犭骨	
徘	彳非	
硝	石肖	
煽	扇火	
皂	七白	
舵	它舟	
嗦	口索	
狈	犭贝	
靴	化革	
捂	吾扌	
疮	仓疒	
郝	赤阝	
苛	可艹	
秽	岁禾	
茜	艹西	
搓	差扌	
芸	云艹	
酱	丬夕酉	
赁	任贝	
檐	木詹	
饷	向饣	
蕉	焦艹	
铀	由钅	
苔	台艹	
赦	攵赤	
缎	段纟	
舷	玄舟	
筷	快竹	
朔	屰月	塑溯
婪	女林	
紊	文糸	
厮	厂斯	
婿	女胥	
寥	宀翏	
兢	克	
糙	米造	
卦	卜圭	褂
槐	木鬼	
扒	八扌	
裴	衣非	
祀	巳礻	
埔	土甫	
絮	如糸	
芭	巴艹	
屉	世尸	
痪	奂疒	
霄	肖雨	
绽	定纟	
宵	宀肖	
邑	口巴	扈邕
霖	林雨	
岔	分山	
饵	耳饣	
茄	加艹	
韧	刃韦	
琪	其王	
邹	刍阝	
瑚	王胡	
憋	心敝	
殆	台歹	
噜	口鲁	
忒	弋心	
忿	分心	
衅	半血	
淳	享氵	
悖	孛忄	
髦	毛髟	
孜	子攵	
粤	丂丿囗米	
隘	益阝	
濒	氵频	
铮	争钅	
畸	奇田	
剔	刂易	
坞	乌土	
篱	离竹	
淀	定氵	
蓦	莫马	
唬	口虎	
锣	罗钅	
汀	丁氵	
趾	止𧾷	
缉	咠纟	
嫦	女常	
斟	斗甚	
鞍	安革	
扳	反扌	
拴	全扌	
诅	且讠	
谟	莫讠	
呃	厄口	
懦	忄需	
逞	呈辶	
犁	利牛	
忏	千忄	
拧	宁扌	
亥	亠人𠂈	该孩刻核咳骇骸劾氦阂颏
佟	亻冬	
叱	口𠤎	
舜	冖爫舛	瞬
绊	半纟	
龚	共龙	
腮	思月	
邸	氐阝	
椒	叔木	
蔚	尉艹	
湛	氵甚	
狩	守犭	
眶	匡目	
栈	戋木	
薇	微艹	
肮	亢月	
瀑	暴氵	
渣	查氵	
褂	卦衤	
叽	几口	
臀	月殿	
妞	丑女	
巍	山魏	
唔	口吾	
疚	久疒	
鲤	里鱼	
戎	戈𠂇	贼绒
肇	聿𢼄	
笃	竹马	
辙	攵育车	
娴	女闲	
阮	元阝	
札	乚木	
懊	奥忄	
焘	寿灬	
恤	忄血	
疹	㐱疒	
潇	氵萧	
铝	吕钅	
涤	条氵	
恃	寺忄	
喽	口娄	
砌	切石	
遁	盾辶	
楞	木𬙙	
阱	井阝	
咎	口处	绺
洼	圭氵	
炳	丙火	
噬	口筮	
枫	木风	
拷	扌考	
哆	口多	
矶	几石	
苇	艹韦	
翩	扁羽	
窒	穴至	
侬	亻农	
靶	巴革	
胰	夷月	
芜	无艹	
辫	纟辛	
嚎	口豪	
妾	女立	接霎
幌	巾晃	
踉	良𧾷	
佃	亻田	
葫	胡艹	
皖	完白	
拽	扌曳	
滤	氵虑	
睬	目采	
俞	亼刖	输偷愈愉喻谕逾瑜榆渝觎揄
匕	丿乚	它此老北死尼旨仑匙颖顷颍
谤	旁讠	
嗤	口蚩	
捍	扌旱	
孵	卵孚	
倪	亻兒	
瘾	疒隐	
敝	㡀攵	蔽弊瞥撇憋鳖蹩
匡	匚王	框眶筐诓
磋	差石	
绫	夌纟	
淆	氵肴	
尧	兀𭠍	烧晓绕饶挠浇翘侥跷骁
蕊	惢艹	
烘	共火	
璋	王章	
亢	亠几	抗航坑杭炕吭肮闶伉
轧	乚车	
赂	各贝	
蝗	皇虫	
榆	俞木	
骏	夋马	
诛	朱讠	
勺	丶勹	的约钓豹灼酌芍
梵	凡林	
炽	只火	
笠	立竹	
颌	合页	
闸	甲门	
狒	弗犭	
樊	大棥	攀
镕	容钅	
垢	后土	
瘟	昷疒	
缪	纟翏	
菇	姑艹	
琦	奇王	
剃	刂弟	
迸	并辶	
溺	弱氵	
炫	火玄	
惚	忄忽	
嗨	口海	
陨	员阝	
赃	庄贝	
羁	罒革马	
臻	秦至	
嘀	口啇	
膳	善月	
赣	夂章贡	
踌	寿𧾷	
殉	旬歹	
桔	吉木	
瞿	䀠隹	衢
闽	虫门	
豚	月豕	
掺	参扌	
沌	屯氵	
惰	左忄月	
喳	口查	
椭	木陏	
咪	口米	
霎	妾雨	
侃	亻口𫶧	
猝	卒犭	
窖	告穴	
戮	戈翏	
祠	司礻	
瞩	属目	
菁	艹青	
躇	著𧾷	
佬	亻老	
肋	力月	筋
咄	出口	
忡	中忄	
雍	乡亠隹	臃
忱	冘忄	
蕾	艹雷	
跄	仓𧾷	
硅	圭石	
伎	亻支	
炊	欠火	
钊	刂钅	
蝠	畐虫	
屎	尸米	
拭	式扌	
谛	帝讠	
褪	衤退	
丞	一氶	拯
卉	十廾	奔贲
隧	遂阝	
茸	耳艹	
钳	甘钅	
啃	口肯	
伢	亻牙	
闺	圭门	
舔	忝舌	
蹬	登𧾷	
挛	亦手	
眺	兆目	
袱	伏衤	
陇	阝龙	
殴	区殳	
柿	市木	
梧	吾木	
惺	忄星	
弛	也弓	
侥	亻尧	
琛	王罙	
捅	扌甬	
酝	云酉	
薯	署艹	
曳	曳	拽曳
澈	攵氵育	
锈	秀钅	
稠	周禾	
眸	牟目	
咆	包口	
簧	竹黄	
鸥	区鸟	
疡	疒𠃓	
渎	卖氵	
汲	及氵	
嬉	喜女	
脓	农月	
骡	累马	
穗	惠禾	
槛	木监	
拎	令扌	
巳	巳	起导包异巷祀巳
邢	开阝	
廿	廿	度席燕庶廿黃
搀	扌𫥎	
曙	日署	
樵	木焦	
隅	禺阝	
筛	师竹	
谒	曷讠	蔼霭
倭	亻委	
痹	畀疒	
猖	昌犭	
佯	亻羊	
肛	工月	
奚	爫𡗞	溪蹊
甭	不用	
抨	平扌	
蛾	我虫	
唠	劳口	
荧	火𫇦	
嵩	山高	
漱	欶氵	
酋	丷酉	尊奠猷
攘	扌襄	
诘	吉讠	
篡	厶𮅕	
睿	八𣦵𥃦	
噩	㗊一干	
怅	忄长	
盎	央皿	
徙	彳歨	
鞅	央革	
漓	氵离	
祟	出示	
睫	疌目	
攸	丨亻攵	悠筱
翎	令羽	
呛	仓口	
筐	匡竹	
堑	土斩	
檀	亶木	
寅	一八宀由	演
磊	石砳	
驭	又马	
惘	忄罔	
吠	口犬	
驮	大马	
瑙	王𡿺	
炬	巨火	
痉	疒𢀖	
曝	日暴	
恺	岂忄	
胺	安月	
萤	虫𫇦	
敕	攵束	整嫩
筝	争竹	
幡	巾番	
霹	辟雨	
竺	二竹	
烙	各火	
毗	比田	
鸠	九鸟	
埠	土阜	
蒜	祘艹	
阜	十𠂤	埠
嘈	口曹	
乒	丘丿	
帷	巾隹	
啄	口豖	
鳌	敖鱼	
毡	占毛	
阙	欮门	
褥	衤辱	
搔	扌蚤	
笋	尹竹	
冕	免冃	
狞	宁犭	
韶	召音	
骼	各骨	
蔼	艹谒	
烹	亨灬	
奄	大电	掩淹俺庵阉腌鹌
嫖	女票	
沐	木氵	
噗	口菐	
岑	今山	涔
蛟	交虫	
掳	扌虏	
咏	口永	
弩	奴弓	
捻	念扌	
圃	囗甫	
孚	子爫	浮乳俘孵
悴	卒忄	
诣	旨讠	
呱	口瓜	
祁	礻阝	
捶	垂扌	
钠	内钅	
袄	夭衤	
澎	彭氵	
氮	气炎	
恪	各忄	
雏	刍隹	
撮	扌最	
堰	匽土	
彷	彳方	
鹦	婴鸟	
晖	军日	
犀	丨丷八尸牛	
腑	府月	
沽	古氵	
橄	敢木	
掐	扌臽	
亵	亠执𧘇	
龋	禹齿	
嗒	口荅	
咀	且口	
祺	其礻	
锚	苗钅	
匾	匚扁	
乓	丘丶	
萃	卒艹	
贻	台贝	
揖	咠扌	
觑	虚见	
吝	口文	
憔	忄焦	
羌	乚羊	
诲	每讠	
砾	乐石	
蠕	虫需	
肴	㐅有	淆
撩	尞扌	
坍	丹土	
酥	禾酉	
袅	④衣	
黝	幼黑	
俾	亻卑	
嫣	女焉	
穹	弓穴	
秧	央禾	
妊	壬女	
溉	既氵	
鹊	昔鸟	
聿	二肀	建律津肆肇
疙	乞疒	
蘑	磨艹	
睾	丿睪	
楷	木皆	
酵	孝酉	
茹	如艹	
锌	辛钅	
滇	氵真	
辗	展车	
纂	糸𮅕	攥
圭	土	封街挂佳鞋娃桂哇奎蛙卦洼硅闺恚鲑畦诖
幔	巾曼	
褒	亠保𧘇	
揍	奏扌	
诽	讠非	
倔	亻屈	
腓	月非	
颉	吉页	撷
锄	助钅	
嗔	口真	
磺	石黄	
攒	扌赞	
瘩	疒荅	
雳	历雨	
吆	口幺	
悚	忄束	
墩	土敦	
彝	廾彑米糸	
囱	丿囗夂	窗
逍	肖辶	
辄	车𦔮	
桅	危木	
俨	严亻	
纶	仑纟	
悸	季忄	
殃	央歹	
帧	巾贞	
俐	亻利	
绮	奇纟	
袒	旦衤	
籽	子米	
孰	丸享	熟塾
愫	忄素	
拌	半扌	
橙	木登	
暨	既旦	
敖	攵𫠤	傲熬鳌赘嗷遨
赘	敖贝	
抉	夬扌	
淤	於氵	
剌	刂束	喇
娼	女昌	
顼	王页	
葵	癸艹	
哝	农口	
酣	甘酉	
麓	林鹿	
钵	本钅	
琅	王良	
簸	竹𤿺	
禾	丿木	和种利科程称委积香税移秘私稳秀秋乘季稍秦租稿穆秩稀秒稣稽颖秃稻稚稼秉秽稠穗酥秧秤秸稷羲穑秆嵇龢秣種稗稹
铢	朱钅	
璧	玉辟	
娠	女辰	
彗	丰彐	慧
惋	宛忄	
腋	夜月	
螂	虫郎	
阪	反阝	
掣	制手	
劾	亥力	
沥	历氵	
粱	刅氵米	
嚓	口察	
惮	单忄	
氖	乃气	
捎	扌肖	
羔	灬𦍌	糕羹
俟	亻矣	
渲	宣氵	
榄	木览	
茧	艹虫	
霓	兒雨	
鹉	武鸟	
胥	月疋	婿
琶	巴玨	
撬	扌毳	
橘	木矞	
醫	殹酉	
拈	占扌	
笆	巴竹	
痊	全疒	
亟	一了叹	
渭	氵胃	
狙	且犭	
珂	可王	
刨	刂包	
蜕	兑虫	
谚	彦讠	
憧	忄童	
瞟	目票	
馒	曼饣	
拗	幼扌	
帚	冖巾彐	埽
钗	叉钅	
哧	口赤	
喋	口枼	
箫	竹肃	
刁	㇀𠃌	叼
怦	平忄	
缭	尞纟	
迥	冋辶	
湄	氵眉	
磐	石般	
渝	俞氵	
冗	冖几	沉壳
闵	文门	悯
噶	口葛	
黏	占黍	
蕃	番艹	
弼	弓百	
驿	马𠬤	
淄	氵甾	
饺	交饣	
踞	居𧾷	
韬	舀韦	
婷	亭女	
唆	口夋	
蜒	延虫	
偎	亻畏	
榨	木窄	
漉	氵鹿	
碉	周石	
皈	反白	
矜	今矛	
笈	及竹	
枷	加木	
鲨	沙鱼	
蹑	聂𧾷	
瀚	氵翰	
酪	各酉	
谑	虐讠	
癖	疒辟	
烬	尽火	
揩	扌皆	
炙	⺀火𠂊	
蜷	卷虫	
侏	亻朱	
凋	冫周	
漪	氵猗	
悻	幸忄	
蹋	𦐇𧾷	
讪	山讠	
搐	扌畜	
碘	典石	
帛	巾白	锦棉绵
诠	全讠	
碾	展石	
擂	扌雷	
苯	本艹	
诃	可讠	
铎	钅𠬤	
戊	戊	成茂戚戊戍戌
荀	旬艹	
驹	句马	
攫	扌矍	
憬	忄景	
哽	口更	
踵	重𧾷	
蟒	莽虫	
漾	氵羕	
啧	口责	
吮	允口	
楠	南木	
氟	弗气	
怂	从心	
叼	刁口	
竣	夋立	
偕	亻皆	
漩	旋氵	
蹭	曾𧾷	
翌	立羽	
臆	意月	
挝	扌过	
绚	旬纟	
崽	山思	
糜	米麻	
瘢	疒般	
跤	交𧾷	
阑	柬门	澜斓
恬	忄舌	
豢	豕龹	
汶	文氵	浏
跷	尧𧾷	
琵	比玨	
憨	心敢	
蜗	呙虫	
螅	息虫	
惴	忄耑	
戟	戈𠦝	
匮	匚贵	
恙	心𦍌	
抿	扌民	
桢	木贞	
笺	戋竹	
蛤	合虫	
瞳	目童	
藥	樂艹	
瓢	瓜票	
衹	氏衤	
秤	平禾	
跺	朵𧾷	
潦	尞氵	
芹	斤艹	
哒	口达	
饬	力饣𠂉	
栩	木羽	
曦	日羲	
骷	古骨	
嫡	啇女	
卤	⺊龱	
丕	一不	胚坯呸
鬓	宾髟	
梓	木辛	
嗖	叟口	
惦	店忄	
浚	夋氵	
咔	卡口	
藐	艹貌	
荃	全艹	醛
唧	即口	
玺	尔玉	
汛	卂氵	
铐	考钅	
髅	娄骨	
渤	勃氵	
皿	皿	益血监盘盖盛盟孟盗盐盆盒盈盏盔盎皿蛊盅盂醯盥
箍	㧜竹	
馅	臽饣	
汾	分氵	
戍	丶戊	蔑篾
痔	寺疒	
褶	習衤	
聆	令耳	
涎	延氵	
汞	工水	
渍	氵责	
奂	冂大𠂊	换唤焕痪涣
巅	山颠	
疣	尤疒	
傩	亻难	
逵	坴辶	
耆	日老	鳍嗜
蟋	悉虫	
鳄	咢鱼	
讹	化讠	
膺	䧹月	
蹿	窜𧾷	
筏	伐竹	
釜	丷父王	
沂	斤氵	
坯	丕土	
峦	亦山	
茬	在艹	
摒	屏扌	
蟀	率虫	
撵	扌辇	
浒	氵许	
缤	宾纟	
嵋	山眉	
珑	王龙	
苞	包艹	
瑾	堇王	
泵	水石	
钾	甲钅	
暧	日爱	
赓	庚贝	
叟	丨又臼	艘搜瘦嫂嗖飕馊
佚	亻失	
沓	日水	踏
撂	扌畧	
蛊	皿虫	
甥	生男	
璐	王路	
晏	安日	鼹
瘪	仓疒自	
漳	氵章	
阉	奄门	
蹂	柔𧾷	
鳃	思鱼	
琏	王连	
湃	拜氵	
辘	车鹿	
僭	亻朁	
躏	蔺𧾷	
鼾	干鼻	
懵	忄瞢	
镰	廉钅	
寐	宀未爿	
褚	者衤	
攥	扌纂	
涧	氵间	
蝙	扁虫	
脐	月齐	
辕	袁车	
涣	奂氵	
杞	己木	
煜	昱火	
骥	冀马	
傣	亻泰	
嗳	口爱	
祯	礻贞	
酉	酉	配酒醒酸醉酷酬醇酿酌酶醋酱酝酋酥酵酣醫酪酉酮酰醮醺酗酚酯醯酢酊醛醴
秸	吉禾	
捺	奈扌	
瑕	叚王	
鑫	金鍂	
馋	饣𫥎	
窿	穴隆	
楔	契木	
胱	光月	
荔	劦艹	
蟆	莫虫	
湍	氵耑	
屹	乞山	
遐	叚辶	
轲	可车	
镯	蜀钅	
缰	畺纟	
桦	华木	
炖	屯火	
钡	贝钅	
羚	令羊	
啬	丷回土	墙蔷穑
诩	羽讠	
绯	纟非	
掖	夜扌	
箓	录竹	
涸	固氵	
鸳	夗鸟	
塾	土孰	
呸	丕口	
抡	仑扌	
擞	扌数	
熹	喜灬	
坷	可土	
瓮	公瓦	
亘	一旦	宣恒桓垣洹
嗟	口差	
筵	延竹	
跛	皮𧾷	
汕	山氵	
欤	与欠	
壑	㕡土	
颍	匕水页	
溥	尃氵	薄簿
姗	册女	
踊	甬𧾷	
枭	④木	
暄	宣日	
稷	畟禾	
跚	册𧾷	
涟	氵连	
瀛	嬴氵	
笙	生竹	
滕	月𣳾	藤
踝	果𧾷	
贰	二弋贝	腻
瞰	敢目	
恻	则忄	
嚏	口疐	
迢	召辶	
獗	厥犭	
邯	甘阝	
睑	佥目	
赡	詹贝	
萦	糸𫇦	
珥	王耳	
酮	同酉	
璞	王菐	
羹	美羔	
缄	咸纟	
晾	京日	
俸	亻奉	
媲	女𣬉	
鸾	亦鸟	
恿	心甬	
蜿	宛虫	
犊	卖牛	
讷	内讠	
扈	户邑	
蜈	吴虫	
翟	羽隹	耀戳曜擢濯
藕	耦艹	
戌	一戊	威咸
蓓	倍艹	
鋆	均金	
谩	曼讠	
谀	臾讠	
卯	卩𠂎	柳聊峁
谙	讠音	
岐	山支	
蝎	曷虫	
荼	余艹	
镀	度钅	
椰	木耶	
甄	垔瓦	
蟾	虫詹	
蹊	奚𧾷	
泞	宁氵	
撸	扌鲁	
螃	旁虫	
檬	木蒙	
猓	果犭	
蔷	啬艹	
羲	③丂禾𦍌	曦
瘸	疒𦙲	
蘸	艹醮	
蔗	庶艹	
傀	亻鬼	
蚌	丰虫	
锢	固钅	
遽	豦辶	
邃	㒸穴辶	
恚	圭心	
皑	岂白	
锵	将钅	
簌	欶竹	
焙	咅火	
昊	天日	
鹳	雚鸟	
睽	癸目	
刽	会刂	
鳖	敝鱼	
噎	口壹	
呗	口贝	
寰	宀睘	
唷	口育	
殡	宾歹	
淖	卓氵	
诰	告讠	
恣	心次	懿
睐	来目	
婵	单女	
榈	木闾	
氦	亥气	
靳	斤革	
蛹	甬虫	
鸯	央鸟	
惬	匚夹忄	
蹙	戚足	
诙	灰讠	
眈	冘目	
罡	正罒	
缮	善纟	
胤	丿乚幺月	
皋	夲白	翱嗥
蛀	主虫	
偌	亻若	
疵	此疒	
绛	夅纟	
葆	保艹	
黔	今黑	
喙	口彖	
烽	夆火	
儡	亻畾	
佼	交亻	
斓	文阑	
嫔	女宾	
颚	咢页	
龈	艮齿	
盅	中皿	
娓	女尾	
坂	反土	
町	丁田	
芥	介艹	
瘠	疒脊	
阂	亥门	
挎	夸扌	
橇	木毳	
荟	会艹	
啜	叕口	
垛	土朵	
淇	其氵	
瓒	王赞	
篓	娄竹	
虱	⺄䖝	
跻	齐𧾷	
龛	合龙	
蹒	䓣𧾷	
髯	冉髟	
瞠	堂目	
痫	疒闲	
掂	店扌	
潼	氵童	
酰	先酉	
镁	美钅	
灸	久火	
腆	典月	
筱	攸竹	
谆	享讠	
骋	甹马	
壬	丿士	任廷妊饪
茗	名艹	
椋	京木	
蛔	回虫	
潺	孱氵	
扉	户非	
耘	云耒	
槟	宾木	
雹	包雨	
甬	用龴	通痛勇涌桶诵捅踊恿蛹俑
谥	益讠	
淞	松氵	
燎	尞火	
蕙	惠艹	
蚪	斗虫	
蜻	虫青	
郸	单阝	
轶	失车	
狰	争犭	
楣	木眉	
捋	寽扌	
涓	氵肙	
荪	孙艹	
娄	女米	数楼屡搂缕喽髅篓褛镂偻
麝	射鹿	
蚤	叉虫	骚搔瘙
薰	熏艹	
醮	焦酉	蘸
搪	唐扌	
谧	讠𥁑	
湮	垔氵	
辍	叕车	
瞌	盍目	
梆	木邦	
樟	木章	
茉	末艹	
岖	区山	
臼	臼	鼠舅叟臼舀臾
癣	疒鲜	
穑	啬禾	
玷	占王	
馍	莫饣	
呷	口甲	
萼	咢艹	
妩	女无	
伫	㝉亻	
彤	丹彡	
莓	每艹	
岬	山甲	
媛	女爰	
惆	周忄	
鳎	鱼𦐇	
啾	口秋	
囔	口囊	
蜓	廷虫	
孺	子需	
徇	彳旬	
徵	彳𢽠	
焊	旱火	
岱	代山	
昵	尼日	
卅	一川	带
飙	猋风	
邙	亡阝	
痞	否疒	
隼	十隹	榫
恫	同忄	
怆	仓忄	
桀	木舛	
绶	受纟	
裆	当衤	
盂	于皿	
桧	会木	
蚓	引虫	
抠	区扌	
嗷	口敖	
槌	木追	
痘	疒豆	
痢	利疒	
芮	内艹	
蚣	公虫	
闩	一门	
铿	坚钅	
飓	具风	
疱	包疒	
蝌	科虫	
撅	厥扌	
蚯	丘虫	
斡	人斗𠦝	
窠	果穴	
荚	夹艹	
耷	大耳	
砚	石见	
牒	枼片	
赈	贝辰	
煦	昫灬	
嗫	口聂	
耙	巴耒	
榕	容木	
鞑	达革	
袤	亠矛𧘇	
谌	甚讠	
醺	熏酉	
秆	干禾	
徨	彳皇	
橹	木鲁	
翡	羽非	
缨	婴纟	
锹	秋钅	
嵇	尤山禾	
圪	乞土	
髻	吉髟	
嗬	口荷	
辎	甾车	
痣	志疒	
娩	免女	
谄	臽讠	
蛐	曲虫	
鹞	䍃鸟	
翱	皋羽	
庖	包广	
籁	竹赖	
蓿	宿艹	
鳗	曼鱼	
疟	一匚疒	
鲇	占鱼	
這	言辶	
嚅	口需	
瘀	於疒	
颔	含页	
黜	出黑	
黠	吉黑	
濑	氵赖	
馁	妥饣	
洵	旬氵	
忐	上心	
忑	下心	
砥	氐石	
咂	匝口	
罹	惟罒	
糠	康米	
匝	匚巾	砸咂
偃	亻匽	
淙	宗氵	
纫	刃纟	
喏	口若	
闾	吕门	榈
祛	去礻	
蛰	执虫	
腼	月面	
涝	劳氵	
曜	日翟	
厩	厂既	
疽	且疒	
闰	王门	润
洄	回氵	
煊	宣火	
汐	夕氵	
藓	艹鲜	
璜	王黄	
铬	各钅	
經	巠糹	
渥	屋氵	
靼	旦革	
酗	凶酉	
苓	令艹	
噤	口禁	
咫	只尺	
椿	春木	
鲫	即鱼	
锭	定钅	
罔	冂𠅇	惘
锺	重钅	
匍	勹甫	葡
祗	氐礻	
锰	孟钅	
岌	及山	
馀	余饣	
畹	宛田	
糯	米需	
胫	月𢀖	
熠	火習	
銮	亦金	
沅	元氵	
棣	木隶	
旌	方生𠂉	
豌	宛豆	
孢	包子	
镭	钅雷	
驸	付马	
腌	奄月	
盹	屯目	
熵	商火	
镐	钅高	
馐	羞饣	
嘤	口婴	
癞	疒赖	
骰	殳骨	
韭	一非	
阖	盍门	
瞑	冥目	
裨	卑衤	
宕	宀石	
戾	户犬	
镌	钅隽	
溟	冥氵	
牍	卖片	
隽	乃隹	携镌
婊	女表	
鹄	告鸟	
埂	土更	
拄	主扌	
娲	呙女	
虬	乚虫	
萱	宣艹	
啵	口波	
蠡	䖵彖	
芋	于艹	
胭	因月	
豺	才豸	
啻	口帝	
褛	娄衤	
蛆	且虫	
柠	宁木	
掰	分手龵	
篆	彖竹	
倌	亻官	
咛	口宁	
蛭	至虫	
谡	畟讠	
荨	寻艹	
莞	完艹	
澹	氵詹	
纭	云纟	
潞	氵路	
郅	至阝	
弋	丶𫠠	代式武戈忒贰鸢
飕	叟风	
螳	堂虫	
胄	月由	
蟑	章虫	
猥	犭畏	
宓	宀必	密蜜
昙	云日	
锏	钅间	
蟠	番虫	
過	咼辶	
柑	木甘	
烯	希火	
匐	勹畐	
濮	僕氵	
蟮	善虫	
祐	右礻	
仄	人厂	
偈	亻曷	
蜃	虫辰	
箴	咸竹	
粼	巜粦	
嗥	口皋	
褴	监衤	
蕨	厥艹	
蓟	艹𬶀	
圩	于土	
孪	亦子	
杳	日木	
魇	厌鬼	
荤	军艹	
诿	委讠	
簪	朁竹	
氲	昷气	
摞	扌累	
飒	立风	
镂	娄钅	
舀	爫臼	稻蹈滔韬
夙	几歹	
臧	戕臣	藏
蒿	艹高	
貂	召豸	
蜥	析虫	
蹩	敝足	
噼	口辟	
钛	太钅	
钚	不钅	
獾	犭雚	
濂	廉氵	
铠	岂钅	
皙	析白	
霭	谒雨	
鲈	卢鱼	
叵	匚口	
霾	貍雨	
泯	民氵	
碴	查石	
鸵	它鸟	
峪	山谷	
饕	號食	
瘁	卒疒	
睢	目隹	
鬃	宗髟	
迩	尔辶	
纣	寸纟	
夔	丷夒	
垠	土艮	
饨	屯饣	
榭	射木	
隍	皇阝	
娑	女沙	
篝	冓竹	
榔	木郎	
洌	列氵	
浜	兵氵	
鲑	圭鱼	
谔	咢讠	
汩	曰氵	
浣	完氵	
舐	氏舌	
瞭	尞目	
忻	忄斤	
咻	休口	
鹑	享鸟	
唑	口坐	
懋	心楙	
皎	交白	
诒	台讠	
麾	毛麻	
辏	奏车	
氐	丶氏	底低抵邸砥祗诋胝骶
冽	冫列	
箕	其竹	
俚	亻里	
汴	卞氵	
宸	宀辰	
芍	勺艹	
捱	厓扌	
摈	宾扌	
摺	扌習	
簦	登竹	
箔	泊竹	
咝	丝口	
孀	女霜	
怏	央忄	
谝	扁讠	
砧	占石	
馕	囊饣	
耄	毛老	
罂	缶贝	
漕	曹氵	
沣	丰氵	
栾	亦木	滦
榘	木矩	
烷	完火	
榷	木隺	
俑	亻甬	
沱	它氵	
缜	真纟	
鹫	就鸟	
蛳	师虫	
剽	刂票	
衢	亍彳瞿	
泗	四氵	
臊	喿月	
瘴	疒章	
酚	分酉	
纾	予纟	
晁	兆日	
孛	冖十子	勃脖悖饽
炀	火𠃓	
叁	三厶大	
憩	心自舌	
掬	匊扌	
椤	木罗	
啮	口齿	
畿	戈田𢆶	
掸	单扌	
镣	尞钅	
骁	尧马	
椽	彖木	
侗	亻同	
滦	栾氵	
荩	尽艹	
泓	弘氵	
蚱	乍虫	
癜	殿疒	
酯	旨酉	
體	豊骨	
癸	天癶	葵睽揆阕
蚜	牙虫	
扪	扌门	
庑	广无	
歆	欠音	
蝮	复虫	
蹶	厥𧾷	
弈	亦廾	
庋	广支	
喟	口胃	
滂	旁氵	
啕	匋口	
蛎	厉虫	
獭	犭赖	
槁	木高	
翊	立羽	
龊	足齿	
邺	业阝	
莘	艹辛	
燮	又火言	
剁	刂朵	
觐	堇见	
铛	当钅	
谗	讠𫥎	
镍	臬钅	
臃	月雍	
墒	商土	
晔	华日	
燔	火番	
嘭	口彭	
涿	氵豖	
醯	㐬皿酉	
箩	竹罗	
鄱	番阝	
睨	兒目	
诤	争讠	
坳	土幼	
鹭	路鸟	
砷	申石	
唏	口希	
伲	亻尼	
猬	犭胃	
琥	王虎	
殁	歹殳	
蚩	㞢虫	嗤媸
泾	氵𢀖	
缥	票纟	
殓	佥歹	
鳅	秋鱼	
氰	气青	
诋	氐讠	
刍	彐𠂊	急趋皱邹雏绉诌
芷	止艹	
嶙	山粦	
逅	后辶	
舫	方舟	
呓	口艺	
唰	刷口	
茁	出艹	
馑	堇饣	
妫	为女	
骧	襄马	
苷	甘艹	
擢	扌翟	
峋	山旬	
袂	夬衤	
懑	心满	
蓑	艹衰	
與	②一丿八𦥑	
涞	来氵	
祉	止礻	
踹	耑𧾷	
掇	叕扌	
沏	切氵	
诳	狂讠	
噫	口意	
饽	孛饣	
饪	壬饣	
绺	咎纟	
谘	咨讠	
飧	夕食	
迳	辶𢀖	
铡	则钅	
枞	从木	
熨	尉火	
鋈	沃金	
荭	红艹	
赊	佘贝	
俦	亻寿	
戛	戈𦣻	嘎
湎	氵面	
幺	②丶	幻幼玄後吆胤
凇	冫松	
芪	氏艹	
觯	单角	
龌	屋齿	
挞	扌达	
嬴	凡吂女月	瀛
苻	付艹	
嘁	口戚	
鞯	荐革	
肽	太月	
恸	动忄	
迨	台辶	
钰	玉钅	
儆	亻敬	
觎	俞见	
讫	乞讠	
滓	宰氵	
僮	亻童	
媾	冓女	
龇	此齿	
胯	夸月	
涮	刷氵	
绾	官纟	
杈	叉木	
赳	丩走	
斛	斗角	
觥	光角	
疸	旦疒	
卞	下丶	汴
愠	忄昷	
拮	吉扌	
庠	广羊	
烨	华火	
龢	禾龠	
菠	波艹	
窈	幼穴	
罄	殸缶	
囤	囗屯	
弁	厶廾	拚
奘	壯大	
咣	光口	
缫	巢纟	
腴	月臾	
缈	眇纟	
喵	口苗	
潢	氵黄	
遛	留辶	
柚	木由	
郏	夹阝	
荻	狄艹	
藜	艹黎	
琨	昆王	
镳	钅麃	
雉	矢隹	
橐	䂞一中冖	
陽	昜阝	
骈	并马	
蛉	令虫	
艮	艮	很眼根跟限退银良恨艰狠痕恳垦龈垠艮
搽	扌茶	
濡	氵需	
寮	宀尞	
柩	匛木	
佗	亻它	
啷	口郎	
诜	先讠	
視	礻見	
偻	亻娄	
夯	力大	
闱	门韦	
谖	爰讠	
夥	多果	
枸	句木	
膑	宾月	
虻	亡虫	
筠	均竹	
埽	土帚	
笞	台竹	
臾	人臼	谀腴庾
婀	女阿	
珞	各王	
粑	巴米	
怵	忄术	
绻	卷纟	
殒	员歹	
觊	岂见	
崂	劳山	
颧	雚页	
嗑	口盍	
榛	木秦	
昱	日立	煜
蜴	易虫	
鳝	善鱼	
噙	口禽	
淼	水沝	
矾	凡石	
硼	朋石	
囿	囗有	
泅	囚氵	
邂	解辶	
钜	巨钅	
蠹	䖵一中冖石	
垩	亚土	
乩	乚占	
嗝	口鬲	
淦	氵金	
樽	尊木	
诮	肖讠	
揆	扌癸	
啐	卒口	
淅	析氵	
榉	举木	
馗	九首	
辔	口纟车	
暹	日辶隹	
骛	敄马	
鱿	尤鱼	
苫	占艹	
犷	广犭	
獠	尞犭	
詈	罒言	
竦	束立	
篙	竹高	
诨	军讠	
铰	交钅	
馄	昆饣	
蜚	虫非	
峒	同山	
滢	氵莹	
琬	宛王	
靓	见青	
狻	夋犭	
璨	王粲	
犟	强牛	
鸬	卢鸟	
螨	虫𬜯	
芩	今艹	
嘹	口尞	
锟	昆钅	
蜇	折虫	
洹	亘氵	
栉	木节	
俪	丽亻	
钍	土钅	
锨	欣钅	
瑁	冒王	
壹	冖士豆	懿噎
痿	委疒	
竑	厷立	
粕	白米	
犄	奇牛	
瘙	疒蚤	
饯	戋饣	
抟	专扌	
衲	内衤	
踮	店𧾷	
龅	包齿	
愎	复忄	
馥	复香	
梏	告木	
讣	卜讠	
邝	广阝	
艿	乃艹	
趺	夫𧾷	
鲟	寻鱼	
剜	刂宛	
绉	刍纟	
罅	缶虖	
笥	司竹	
衩	叉衤	
姣	交女	
斫	斤石	
鹗	咢鸟	
腎	月臤	
爻	㐅乂	驳
猕	弥犭	
晗	含日	
铩	杀钅	
窕	兆穴	
仨	三亻	
搡	扌桑	
崴	威山	
酢	乍酉	
檄	敫木	
佞	亻𡚬	
孑	孑	孑
璀	崔王	
岷	山民	
舛	㐄夕	舞舜桀
邕	巛邑	
闿	岂门	
铂	白钅	
霁	雨齐	
犒	牛高	
馏	留饣	
阈	或门	
麋	米鹿	
麒	其鹿	
苁	从艹	
摁	恩扌	
涔	岑氵	
宥	宀有	
妍	女开	
铤	廷钅	
锷	咢钅	
嗲	口爹	
恽	军忄	
麂	几鹿	
赝	贝雁	
胛	月甲	
哂	口西	
撷	扌颉	
呶	口奴	
噘	厥口	
懔	忄禀	
栎	乐木	
桎	木至	
霰	散雨	
飨	乡食	
揄	俞扌	
噔	口登	
娣	女弟	
薏	意艹	
忝	㣺天	添舔
咤	口宅	
嗵	口通	
迤	㐌辶	
贲	卉贝	愤喷
胪	卢月	
鍪	敄金	
泸	卢氵	
蔫	焉艹	
刈	㐅刂	
僖	亻喜	
咿	伊口	
鹌	奄鸟	
嗪	口秦	
茏	艹龙	
茯	伏艹	
岫	山由	
嵘	山荣	
轱	古车	
怼	对心	
铨	全钅	
昕	斤日	
郢	呈阝	
咩	口羊	
馊	叟饣	
髡	兀髟	
澧	氵豊	
苣	巨艹	
濯	氵翟	
盥	水皿𦥑	
囡	囗女	
砺	厉石	
佘	人示	赊
谶	讠韱	
弑	式杀	
楂	木查	
翦	前羽	
怩	尼忄	
蠼	矍虫	
霏	雨非	
楹	木盈	
讴	区讠	
锲	契钅	
慵	庸忄	
胝	月氐	
砭	乏石	
潍	氵维	
杵	午木	
樾	木越	
帼	国巾	
碣	曷石	
诌	刍讠	
徕	彳来	
胴	同月	
钴	古钅	
裟	沙衣	
啶	口定	
铣	先钅	
铱	衣钅	
楫	咠木	
赭	者赤	
碛	石责	
酊	丁酉	
魑	离鬼	
醛	荃酉	
剐	刂呙	
畦	圭田	
陂	皮阝	
闶	亢门	
阄	门龟	
祚	乍礻	
鹘	骨鸟	
泱	央氵	
趄	且走	
骅	华马	
陲	垂阝	
郧	员阝	
倜	亻周	
呤	令口	
燧	火遂	
铉	玄钅	
粲	米𣦼	璨
骶	氐骨	
峁	卯山	
忸	丑忄	
渌	录氵	
骞	马𡨄	
髭	此髟	
戡	戈甚	
钨	乌钅	
谲	矞讠	
苋	艹见	宽
锃	呈钅	
蜊	利虫	
幄	屋巾	
闼	达门	
戕	戈爿	臧
骊	丽马	
虢	寽虎	
烩	会火	
傥	亻党	
妲	女旦	
绌	出纟	
桠	亚木	
袈	加衣	
鎗	倉金	
薮	数艹	
揿	扌钦	
杲	日木	桌
肓	亡月	
厝	厂昔	
莅	位艹	
氤	因气	
缙	晋纟	
衮	亠公𧘇	滚
诟	后讠	
旖	奇方𠂉	
硒	石西	
唁	口言	
嬗	亶女	
硎	刑石	
裱	衤表	
颦	卑频	
質	斦貝	
靥	厌面	
纥	乞纟	
煨	火畏	
礴	石薄	
鏖	金鹿	
蝈	国虫	
笏	勿竹	
羿	廾羽	
鼐	乃鼎	
湟	氵皇	
甑	曾瓦	
炜	火韦	
煲	保火	
锉	坐钅	
笕	竹见	
喑	口音	
嶂	山章	
浔	寻氵	
弭	弓耳	
妪	区女	
锂	里钅	
苡	以艹	
孳	兹子	
颏	亥页	
醴	豊酉	
間	日門	
渚	氵者	
轭	厄车	
鹬	矞鸟	
蚝	毛虫	
黃	一八廿由	
膘	月票	
邛	工阝	
痨	劳疒	
褡	荅衤	
耦	禺耒	藕
覃	早覀	谭潭
虛	⑥虍	
馔	巽饣	
篾	戍竹罒	
兖	亠兊	
阋	兒门	
遨	敖辶	
爰	一友爫	缓援暖媛谖
痂	加疒	
艄	肖舟	
耨	耒辱	
沤	区氵	
邋	巤辶	
焓	含火	
秣	末禾	
昶	日永	
種	禾重	
變	䜌攵	
窣	卒穴	
绦	条纟	
俎	且仌	
榫	木隼	
蟪	惠虫	
稗	卑禾	
謇	言𡨄	
氩	亚气	
類	頁类	
锴	皆钅	
龉	吾齿	
烃	火𢀖	
俣	亻吴	
嬷	女麽	
肱	厷月	
鸢	弋鸟	
笫	竹𠂔	
痤	坐疒	
陰	侌阝	
菏	河艹	
莆	甫艹	
芨	及艹	
阕	癸门	
砣	它石	
碜	参石	
鼹	晏鼠	
長	④一丿乀𠄌	
猷	犬酋	
竽	于竹	
舸	可舟	
诓	匡讠	
錾	斩金	
淬	卒氵	
隗	阝鬼	
悌	弟忄	
姘	女并	
槭	戚木	
邈	貌辶	
婕	女疌	
歙	欠翕	
稹	真禾	
蹴	就𧾷	
砒	比石	
痈	用疒	
镏	留钅	
羯	曷羊	
豕	一𧰨	家逐豪豚豢
鲂	方鱼	
蓖	艹𣬉	
匦	匚轨	
笤	召竹	
峥	争山	
徭	䍃彳	
浃	夹氵	
烊	火羊	
補	甫衤	
窸	悉穴	
酆	豐阝	
缢	益纟	
褓	保衤	
蚨	夫虫	
翳	殹羽	
趔	列走	
炔	夬火	
誊	言龹	
赜	责𦣞	
仃	丁亻	
勖	冒力	
葺	咠艹	
蚴	幼虫	
泷	氵龙	
蛴	虫齐	
結	吉糹	
媸	女蚩	
俳	亻非	
诖	圭讠	
茑	艹鸟	
逡	夋辶	
孱	孨尸	潺
砦	此石	
跸	毕𧾷	
祜	古礻	
伉	亢亻	
溴	氵臭	
屐	尸𫹍	
飚	焱风	
蛞	舌虫	
鏡	竟金	
掮	扌肩	
崆	山空	
庾	广臾	
橛	厥木	
矸	干石	
鸨	鸟𠤏	
圻	土斤	
缂	纟革	
蒯	刂萠	
诹	取讠	
啭	口转	
饧	饣𠃓	
镉	钅鬲	
鸪	古鸟	
蛩	巩虫	
蠖	蒦虫	
說	兌言	
劭	力召	
哐	匡口	
崧	山松	
杼	予木	
棂	木灵	
螫	虫赦	
龃	且齿	
饔	雍食	
遑	皇辶	
颢	景页	
腱	建月	
襁	强衤	
忾	忄气	
濠	氵豪	
牝	匕牛	
蛄	古虫	
鲆	平鱼	
嗄	口夏	
灏	澋页	
疥	介疒	
苜	目艹	
荞	乔艹	
嘣	口崩	
夤	夕寅	
砝	去石	
颞	聂页	
開	开門	
忤	午忄	
遢	辶𦐇	
旎	尼方𠂉	
瘛	恝疒	
魉	两鬼	
辇	㚘车	撵
見	儿目	視
瓤	瓜襄	
荥	艹𠕽	
涫	官氵	
娌	女里	
氚	川气	
臁	廉月	
毂	冖士殳车	
碇	定石	
毖	必比	
壅	土雍	
吡	口比	
缛	纟辱	
玮	王韦	
羟	羊𢀖	
還	睘辶	
珈	加王	
颀	斤页	
虼	乞虫	
祇	氏礻	
佝	亻句	
翕	合羽	歙
遴	粦辶	
珏	玉王	
郛	孚阝	
較	交車	
驗	僉馬	
玖	久王	
蹇	足𡨄	
逋	甫辶	
氅	敞毛	
粽	宗米	
诂	古讠	
岢	可山	
聒	耳舌	
髁	果骨	
黍	人氺禾	黏
芾	巿艹	
淝	氵肥	
鲎	冖鱼𭕄	
鞣	柔革	
髋	宽骨	
闳	厷门	
潆	氵萦	
汨	日氵	
胍	月瓜	
阏	於门	
钤	今钅	
鹜	敄鸟	
鬈	卷髟	
铵	安钅	
戬	戈晋	
點	占黑	
崮	固山	
枰	平木	
樯	啬木	
脍	会月	
畲	佘田	
衾	今衣	
蹼	菐𧾷	
題	是頁	
劬	力句	
咭	口吉	
囫	勿囗	
洱	氵耳	
刎	刂勿	
芏	土艹	
琊	王邪	
碚	咅石	
鳕	雪鱼	
谪	啇讠	
芎	弓艹	
恂	忄旬	
槿	堇木	
鲢	连鱼	
鲧	系鱼	
嘧	口密	
绀	甘纟	
郦	丽阝	
噱	口豦	
浠	希氵	
潸	月林氵	
跏	加𧾷	
鲶	念鱼	
矍	又瞿	攫蠼
苌	艹长	
抻	扌申	
琰	炎王	
鹚	兹鸟	
龆	召齿	
臬	木自	镍
芄	丸艹	
呔	口太	
雒	各隹	
觞	角𠂉𠃓	
钒	凡钅	
饫	夭饣	
阒	狊门	
槎	差木	
鸩	冘鸟	
舂	臼𡗗	
谠	党讠	
阡	千阝	
莒	吕艹	
萸	臾艹	
妗	今女	
稔	念禾	
穰	禾襄	
蚧	介虫	
餍	厌食	
谯	焦讠	
芗	乡艹	
菸	於艹	
葩	皅艹	
踔	卓𧾷	
厣	厌甲	
佻	亻兆	
嘌	口票	
饩	气饣	
钏	川钅	
蠓	蒙虫	
黩	卖黑	
倨	亻居	
腸	昜月	
缬	纟颉	
殚	单歹	
钿	田钅	
鎏	流金	
恁	任心	
藿	艹霍	
囟	㐅丿囗	
鄣	章阝	
呋	口夫	
婺	女敄	
绱	尚纟	
瓯	区瓦	
旃	丹方𠂉	
锶	思钅	
酩	名酉	
恹	厌忄	
逶	委辶	
缦	曼纟	
鸹	舌鸟	
螟	冥虫	
菟	兔艹	
阗	真门	
濉	氵睢	
篑	竹贵	
醪	翏酉	
鲛	交鱼	
讦	干讠	
媪	女昷	
邬	乌阝	
殇	歹𠂉𠃓	
鄯	善阝	
芡	欠艹	
嫠	女𠩺	
肼	井月	
峤	乔山	
矽	夕石	
讧	工讠	
掼	扌贯	
焖	火闷	
愆	心衍	
聩	耳贵	
岘	山见	
靛	定青	
菖	昌艹	
卟	卜口	
姒	以女	
杷	巴木	
砉	丰石	
袢	半衤	
蚋	内虫	
笳	加竹	
挈	㓞手	
關	門𢇇	
踽	禹𧾷	
黾	口电	绳蝇
麼	幺麻	
侩	亻会	
凫	④几	
诔	耒讠	
郯	炎阝	
韪	是韦	
挲	手沙	
笪	旦竹	
鼋	元黾	
莜	攸艹	
風	䖝几	
菅	官艹	
嵊	乘山	
裢	衤连	
趿	及𧾷	
箸	竹者	
莴	呙艹	
莠	秀艹	
阌	受门	
旯	九日	
圜	囗睘	
涪	咅氵	
赍	从冖十贝	
柞	乍木	
嗍	口朔	
囵	仑囗	
榧	匪木	
裰	叕衤	
笾	竹边	
簟	竹覃	
跎	它𧾷	
巽	共巳	撰馔
曷	匃日	喝揭歇葛渴竭褐遏谒蝎偈碣羯
逖	狄辶	
骓	隹马	
绔	夸纟	
枋	方木	
镒	益钅	
魃	犮鬼	
餮	殄食	
讵	巨讠	
乜	乜	
鄢	焉阝	
瑭	唐王	
踅	折足	
馓	散饣	
蟛	彭虫	
鳟	尊鱼	
荛	尧艹	
菬	沼艹	
忪	公忄	
阍	昏门	
姹	女宅	
纰	比纟	
桉	安木	
氪	克气	
氘	丨丿气	
垅	土龙	
郃	合阝	
汊	叉氵	
娉	女甹	
纡	于纟	
缟	纟高	
旮	九日	
镢	厥钅	
傈	亻栗	
堋	土朋	
蔺	艹𫔴	躏
庥	休广	
枥	历木	
腭	咢月	
鹕	胡鸟	
笮	乍竹	
髂	客骨	
魍	罔鬼	
缁	甾纟	
槊	朔木	
跞	乐𧾷	
醚	迷酉	
吒	乇口	
枳	只木	
搿	合手龵	
鹧	庶鸟	
蜍	余虫	
舻	卢舟	
鏊	敖金	
禳	礻襄	
蒺	疾艹	
钹	犮钅	
蜢	孟虫	
鬻	粥鬲	
珩	王行	
卮	㔾𠂋	
垭	亚土	
苄	卞艹	
苕	召艹	
菀	宛艹	
骠	票马	
袷	合衤	
跹	迁𧾷	
瘘	娄疒	
騔	曷馬	
論	侖言	
磬	殸石	
缶	缶	缺窑罐缸罂罄罅
笸	叵竹	
鸷	执鸟	
頭	豆頁	
芰	支艹	
蕲	单斤艹	
阆	良门	
纨	丸纟	
琮	宗王	
牦	毛牛	
砩	弗石	
蠲	益蜀	
锒	良钅	
锕	钅阿	
郓	军阝	
妯	女由	
驷	四马	
鹩	尞鸟	
舢	山舟	
趸	万足	
證	登言	
養	食𦍌	
芫	元艹	
嗉	口素	
蠊	廉虫	
笊	爪竹	
莸	犹艹	
饴	台饣	
阃	困门	
浯	吾氵	
枇	木比	
焱	火炏	飚
铆	卯钅	
擤	扌鼻	
柢	木氐	
醢	酉𥁓	
呲	口此	
崾	山要	
溆	叙氵	
潴	氵猪	
牖	户片甫	
硪	我石	
碓	石隹	
鹆	谷鸟	
鬣	巤髟	
堀	土屈	
帙	失巾	
雱	方雨	
須	彡頁	
進	辶隹	
诎	出讠	
獐	犭章	
桁	木行	
蛱	夹虫	
鳏	眔鱼	
郴	林阝	
幂	巾𠖇	
箝	拑竹	
僳	亻粟	
疝	山疒	
茴	回艹	
揶	扌耶	
呦	口幼	
嗌	口益	
囹	令囗	
螈	原虫	
脲	尿月	
镊	聂钅	
锑	弟钅	
胨	东月	
膈	月鬲	
痼	固疒	
鳊	扁鱼	
赅	亥贝	
贽	执贝	
處	処虍	
苤	丕艹	
峄	山𠬤	
桡	尧木	
雎	且隹	
鲋	付鱼	
鞫	訇革	
鼬	由鼠	
獯	熏犭	
昀	匀日	
痍	夷疒	
蟊	䖵矛	
鞴	革𤰇	
疖	丨疒𠃌	
熘	火留	
乇	七丿	托宅
羸	凡吂月羊	
嵴	山脊	
栀	卮木	
槲	斛木	
炝	仓火	
炷	主火	
硐	同石	
锸	臿钅	
鹂	丽鸟	
裾	居衤	
侪	亻齐	
診	㐱言	
調	周言	
珐	去王	
縯	寅糹	
哔	口毕	
屙	尸阿	
旆	巿方𠂉	
佰	亻百	宿
僦	亻就	
牯	古牛	
钪	亢钅	
掾	彖扌	
針	十金	
仟	亻千	
圮	土己	
芟	殳艹	
崃	山来	
廪	广禀	
擘	手辟	
笱	句竹	
跗	付𧾷	
鲅	犮鱼	
硷	佥石	
苎	㝉艹	
匏	包夸	
嗾	口族	
圄	吾囗	
彀	一冖士弓殳	
粳	更米	
卣	⺊囙	
勐	力孟	
掴	国扌	
涑	束氵	
浞	氵足	
玳	代王	
愍	心敃	
畛	㐱田	
赧	赤𠬝	
貉	各豸	
擀	幹扌	
湫	氵秋	
逦	丽辶	
椴	木段	
铄	乐钅	
箧	匚夹竹	
刖	刂月	前俞
鲮	夌鱼	
訇	勹言	
茱	朱艹	
啖	口炎	
悭	坚忄	
愀	忄秋	
朐	句月	
畈	反田	
鹨	翏鸟	
蛘	羊虫	
佶	亻吉	
缃	相纟	
晟	成日	
鲱	非鱼	
凼	凵水	
苴	且艹	
颛	耑页	
厍	厂车	
匚	匚	区医汇匹匠匪虐匿匣匡匾匮惬疟匝叵匦
徉	彳羊	
洙	朱氵	
氡	冬气	
胗	㐱月	
癯	疒瞿	
鞒	乔革	
锆	告钅	
佤	亻瓦	
錢	戔金	
飲	欠飠	
細	田糹	
勰	劦思	
钺	戉钅	
繇	䍃系	
螭	离虫	
嵬	山鬼	
轸	㐱车	
肟	亏月	
肫	屯月	
邨	屯阝	
瘿	婴疒	
仞	亻刃	
奁	区大	
宄	九宀	
轳	卢车	
熳	曼火	
睇	弟目	
钼	目钅	
蝼	娄虫	
跆	台𧾷	
樗	木雩	
鲰	取鱼	
節	即竹	
诶	矣讠	
薜	艹辟	
铧	华钅	
裥	衤间	
榇	亲木	
馃	果饣	
術	亍彳术	
蹚	堂𧾷	
怄	区忄	
寤	宀𤕻	
缗	昬纟	
硗	尧石	
碡	毒石	
矬	坐矢	
鸱	氐鸟	
虺	兀虫	
糅	柔米	
雠	讠隹	
帑	奴巾	
镧	钅阑	
埙	员土	
啁	口周	
悒	忄邑	
犍	建牛	
硌	各石	
锩	卷钅	
虿	万虫	
蛑	牟虫	
艉	尾舟	
钅	钅	钱错银铁销钟镇针镜键锁钢铺锋钻铜锐锦铃锡铭锅链钦钩钉钓衔钥钧镑铸锻铅钞钮镖锤钙镶铲钝锥锯铀铮锣铝镕钊钳锈钠锚锌锄钵铢钗铎铐钾镰镯钡镀锢锵镁铿锹铬锭锺锰镭镐镌锏镂钛钚铠镣铛镍铡钰镳钜铰锟钍锨铩铂铤锷铨锲钴铣铱铉钨锃锉锂锴镏
咴	口灰	
筮	巫竹	噬
艏	舟首	
糁	参米	
鼍	㽞一黾	
肄	聿𠤕	
籴	入米	
骜	敖马	
砻	石龙	
蜮	或虫	
龀	匕齿	
黢	夋黑	
劢	万力	
腫	月重	
耪	旁耒	
鬯	匕𠚍	
畚	厶大田	
觳	一冖士殳角	
稞	果禾	
鹁	孛鸟	
鲲	昆鱼	
稱	爯禾	
捌	别扌	
菔	服艹	
獬	犭解	
柘	木石	
娆	女尧	
篪	竹虒	
鲀	屯鱼	
谰	讠阑	
孬	不好	
伥	亻长	
谇	卒讠	
鄄	垔阝	
狎	犭甲	
闫	三门	
滟	氵艳	
齑	韭齐	
遒	辶酋	
磔	桀石	
聃	冉耳	
綦	其糸	
鲡	丽鱼	
蔻	寇艹	
泠	令氵	
砗	石车	
钕	女钅	
镫	登钅	
菹	沮艹	
胂	月申	
煅	段火	
煸	扁火	
螯	敖虫	
躅	蜀𧾷	
鲠	更鱼	
佥	一亼𭕄	验脸险检剑签捡俭敛睑殓
罘	不罒	
嶝	山登	
適	啇辶	
坨	土它	
菽	叔艹	
哞	口牟	
徜	尚彳	
慊	兼忄	
洳	如氵	
渑	氵黾	
灞	氵霸	
盍	去皿	磕瞌阖嗑
钋	卜钅	
鸫	东鸟	
踯	郑𧾷	
縻	糸麻	
萘	奈艹	
褫	虒衤	
羰	炭羊	
腦	月𡿺	
俅	亻求	
芤	孔艹	
隳	隋𠇍	
洮	兆氵	
胼	并月	
罴	灬罢	
镛	庸钅	
怛	忄旦	
芊	千艹	
啉	口林	
噌	口曾	
嫱	啬女	
绲	昆纟	
膻	亶月	
焐	吾火	
裡	衤里	
葎	律艹	
亓	一丌	
倮	亻果	
莼	纯艹	
蘅	艹衡	
嘞	勒口	
缒	纟追	
镆	莫钅	
網	糹罔	
伧	亻仓	
荏	任艹	
唳	口戾	
檩	木禀	
鸶	丝鸟	
蚬	虫见	
骱	介骨	
蘖	木薛	
澍	尌氵	
韫	昷韦	
颎	页𭴁	
嘏	叚古	
垡	伐土	
腚	定月	
焯	卓火	
繻	糹需	
怙	古忄	
羧	夋羊	
鼙	卑鼓	
倥	亻空	
亳	乇亠冖口	
艽	九艹	
荠	艹齐	
昴	卯日	
舨	反舟	
魈	肖鬼	
醣	唐酉	
枵	号木	
粜	出米	
甙	弋甘	
珲	军王	
杓	勺木	
楸	木秋	
楦	宣木	
疃	田童	
蛏	圣虫	
蠛	蔑虫	
髌	宾骨	
茔	土𫇦	
臨	品臣𠂉	
诼	讠豖	
嬖	女辟	
耒	一未	耗耕耘耙耦耨
蜣	羌虫	
笄	开竹	
跣	先𧾷	
钣	反钅	
戆	心赣	
蜉	孚虫	
喾	冖告𭕄	
铍	皮钅	
陉	阝𢀖	
薹	臺艹	
肷	月欠	
岵	古山	
瓴	令瓦	
荽	妥艹	
怫	弗忄	
钭	斗钅	
窀	屯穴	
缯	曾纟	
倬	亻卓	
摭	庶扌	
帔	巾皮	
楝	木柬	
痱	疒非	
蚶	甘虫	
螬	曹虫	
髑	蜀骨	
紅	工糹	
鼗	兆鼓	
狷	犭肙	
殛	亟歹	
裉	艮衤	
粝	厉米	
萋	妻艹	
葭	叚艹	
衽	壬衤	
鳢	豊鱼	
傧	亻宾	
喁	口禺	
嫘	女累	
罟	古罒	
钌	了钅	
裼	易衤	
愦	忄贵	
蝽	春虫	
雖	虽隹	
锗	者钅	
衿	今衤	
粢	次米	
醵	豦酉	
跫	巩足	
鐾	辟金	
廛	儿土广里	
墉	土庸	
哌	口𠂢	
輕	巠車	
扦	千扌	
堇	口廿龶	勤谨瑾觐馑
婧	女青	
暌	日癸	
罱	南罒	
镞	族钅	
蹰	厨𧾷	
陟	步阝	
鳔	票鱼	
脘	完月	
臟	月藏	
岿	山归	
侔	亻牟	
郾	匽阝	
唿	口忽	
砹	石艾	
疴	可疒	
麸	夫麦	
薨	冖死罒艹	
綝	林糹	
滁	氵除	
偾	亻贲	
拊	付扌	
撺	扌窜	
呒	口无	
狯	会犭	
猢	犭胡	
椁	享木	
榱	木衰	
罾	曾罒	
铳	充钅	
裎	呈衤	
鳚	尉鱼	
眦	此目	
璎	婴王	
認	忍言	
崞	享山	
缇	是纟	
蝣	斿虫	
萑	艹隹	
狲	孙犭	
缱	纟遣	
晷	咎日	
冼	先冫	
痧	沙疒	
統	充糹	
蕖	渠艹	
狍	包犭	
憷	忄楚	
锛	奔钅	
窨	穴音	
袼	各衤	
帏	巾韦	
儋	亻詹	
绨	弟纟	
疠	万疒	
蘩	繁艹	
嵝	娄山	
庀	匕广	
汜	巳氵	
炅	日火	
煳	火胡	
泶	冖水𭕄	
瓠	夸瓜	
窳	㼌穴	
虮	几虫	
蚰	由虫	
邰	台阝	
苊	厄艹	
砀	石𠃓	
捩	戾扌	
蹉	差𧾷	
莪	我艹	
螽	䖵冬	
覺	見𦥯	
蘼	艹靡	
槔	木皋	
曛	日熏	
蛲	尧虫	
鹾	卤差	
隹	隹	难准集推维谁雄唯售雅堆霍截焦雇雕惟淮雀雌椎崔稚锥瞿雍帷雏翟隼隽睢雉暹
犸	犭马	
衄	丑血	
觀	見雚	
轉	專車	
銎	巩金	
泫	氵玄	
玢	分王	
辊	昆车	
瞋	目真	
墀	土犀	
酐	干酉	
隱	㥯阝	
堞	土枼	
尥	勺尢	
嚯	口霍	
猗	奇犭	漪
逑	求辶	
逯	录辶	
硖	夹石	
噻	口塞	
嵛	俞山	
畀	丌田	鼻痹
運	軍辶	
鲃	巴鱼	
偬	亻怱	
鄞	堇阝	
呖	历口	
溧	栗氵	
嬲	女男	
肭	内月	
鹈	弟鸟	
鹱	蒦鸟	
窭	娄穴	
黧	黑𥝢	
谵	詹讠	
沆	亢氵	
嫒	女爱	
塬	原土	
缣	兼纟	
篯	竹钱	
酃	阝霝	
喱	厘口	
泔	氵甘	
溘	氵盍	
迕	午辶	
肀	コ一丨	唐聿
秫	术禾	
裣	佥衤	
铋	必钅	
蒌	娄艹	
曩	日襄	
赀	此贝	
箪	单竹	
朊	元月	
鳙	庸鱼	
仫	么亻	
钎	千钅	
芑	己艹	
胙	乍月	
盱	于目	
糇	侯米	
挹	扌邑	
捭	卑扌	
悱	忄非	
鬟	睘髟	
緩	爰糹	
請	言青	
崤	山肴	
澶	亶氵	
甾	巛田	淄辎
欹	奇欠	
瞽	目鼓	
钇	乙钅	
鹪	焦鸟	
鞔	免革	
缡	离纟	
铯	色钅	
鲚	鱼齐	
組	且糹	
嘬	口最	
庹	尺广廿	
渖	审氵	
湔	前氵	
玎	丁王	
锜	奇钅	
锊	寽钅	
舾	舟西	
籼	山米	
阊	昌门	
祕	必礻	
猊	兒犭	
燹	火豩	
葑	封艹	
蓼	翏艹	
幛	巾章	
岣	句山	
浼	免氵	
甯	用𫲽	
瑷	爱王	
敫	攵方白	激缴邀檄
钔	钅门	
钫	方钅	
锼	叟钅	
锿	哀钅	
癔	意疒	
穸	夕穴	
褊	扁衤	
蚍	比虫	
篦	竹𣬉	
麇	禾鹿	
樘	堂木	
钯	巴钅	
禇	礻者	
铒	耳钅	
續	糹賣	
莩	孚艹	
嵯	山差	
逭	官辶	
遄	耑辶	
戗	仓戈	
睃	夋目	
鮈	句魚	
瀣	氵韰	
皴	夋皮	
泮	半氵	
轫	刃车	
褰	衣𡨄	
炱	台火	
醍	是酉	
锱	甾钅	
篁	皇竹	
葚	甚艹	
難	口夫廿隹	
矇	目蒙	
驽	奴马	
辚	粦车	
睥	卑目	
鸺	休鸟	
筇	竹邛	
戥	戈星	
髀	卑骨	
驺	刍马	
頸	巠頁	
哙	会口	
濞	氵鼻	
逄	夅辶	
桤	岂木	
攵	攵	政教数放改收敌致效故攻敢败散救敬撤敏牧敦枚玫敞敷敛赦孜辙敝澈攸敕敖變
炻	火石	
磙	石衮	
疳	甘疒	
醭	菐酉	
鳇	皇鱼	
鹮	睘鸟	
迓	牙辶	
眇	少目	渺缈
楮	木者	
砜	石风	
謝	射言	
離	离隹	
約	勺糹	
菘	松艹	
馇	查饣	
栌	卢木	
醐	胡酉	
唢	口𭕆	
獍	犭竟	
殳	又𠘧	没设投段般股毁役殿疫毅殷殴骰殁
仡	乞亻	
軟	欠車	
刿	刂岁	
葜	契艹	
薅	媷艹	
湓	氵盆	
搴	手𡨄	
尕	乃小	
磴	登石	
锝	㝵钅	
镅	眉钅	
艚	曹舟	
殄	㐱歹	
暝	冥日	
祢	尔礻	
豉	支豆	
垴	㐫土	
維	糹隹	
瓿	咅瓦	
煺	火退	
蟥	虫黄	
蹀	枼𧾷	
門	𠁣𠃛	間
黼	甫黹	
氙	山气	
铑	老钅	
積	禾責	
線	泉糹	
蒡	旁艹	
杪	少木	
肜	彡月	
膂	旅月	
砬	石立	
硭	石芒	
酽	严酉	
踟	知𧾷	
鲷	周鱼	
蒴	朔艹	
藁	槀艹	
猡	犭罗	
旒	㐬方𠂉	
硇	囟石	
锍	㐬钅	
鞲	冓革	
哿	加可	
皤	番白	
哏	口艮	
殍	孚歹	
漯	氵累	
確	石隺	
織	戠糹	
連	車辶	
谂	念讠	
跶	达𧾷	
橥	木猪	
镬	蒦钅	
鸲	句鸟	
姝	女朱	
茭	交艹	
窆	乏穴	
髟	彡镸	髦鬓髯髻鬃髡髭
畋	攵田	
溏	唐氵	
鲔	有鱼	
顯	㬎頁	
喹	口奎	
紹	召糹	
吣	口心	
羼	尸羴	
缧	累纟	
窬	俞穴	
骘	陟马	
赉	来贝	
镓	家钅	
邳	丕阝	
璩	王豦	
鸸	而鸟	
涠	围氵	
溲	叟氵	
孥	奴子	
敉	攵米	
筌	全竹	
䜣	斤讠	
義	我𦍌	
衛	亍彳韋	
響	鄉音	
蹓	留𧾷	
垓	亥土	
苒	冉艹	
荸	孛艹	
甓	瓦辟	
锪	忽钅	
镄	费钅	
脔	亦肉	
艟	童舟	
選	巽辶	
達	辶𦍒	
眬	目龙	
彘	匕彑矢	
檠	敬木	
胩	卡月	
旄	方毛𠂉	
祆	天礻	
伛	亻区	
鲥	时鱼	
荦	牛𫇦	
暾	敦日	
脈	月𠂢	
納	内糹	
缌	思纟	
飏	风𠃓	
锞	果钅	
趵	勺𧾷	
跖	石𧾷	
跬	圭𧾷	
僬	亻焦	
皲	军皮	
翥	羽者	
祎	礻韦	
貢	工貝	
習	白羽	褶熠摺
閉	才門	
芴	勿艹	
菰	孤艹	
眙	台目	
锓	钅𠬶	
訾	此言	
莳	时艹	
菪	宕艹	
槠	木诸	
榍	屑木	
俜	亻甹	
觚	瓜角	
撄	婴扌	
嵫	兹山	
桴	孚木	
晡	日甫	
爨	冖同𤍾𦥑	
悫	壳心	
锇	我钅	
锖	钅青	
锘	若钅	
蝾	荣虫	
糌	昝米	
柙	木甲	
滹	氵虖	
睚	厓目	
辦	力辛	
莨	良艹	
尻	九尸	
罨	奄罒	
锔	局钅	
筲	竹肖	
妣	女比	
砘	屯石	
谳	献讠	
钽	旦钅	
鈤	日金	
脹	月長	
遺	貴辶	
鄹	聚阝	
菡	函艹	
崦	奄山	
狺	犭言	
杌	兀木	
秭	禾𠂔	
舯	中舟	
豇	工豆	
鲵	兒鱼	
蘧	艹遽	
阚	敢门	
悝	忄里	
铌	尼钅	
預	予頁	
缑	侯纟	
瑗	爰王	
椹	木甚	
旰	干日	
魆	戉鬼	
蓍	耆艹	
蕹	艹雍	
岜	山巴	
钐	彡钅	
锬	炎钅	
镪	强钅	
绡	纟肖	
檎	木禽	
穀	殳𥞤	
茕	卂𫇦	
話	舌言	
縮	宿糹	
顧	雇頁	
荈	舛艹	
侉	亻夸	
渫	枼氵	
辂	各车	
欷	希欠	
轾	至车	
麴	匊麥	
戢	咠戈	
趼	开𧾷	
誤	吴言	
芈	丨二艹	
苈	历艹	
缍	垂纟	
歃	欠臿	
燠	奥火	
耜	㠯耒	
顸	干页	
蚵	可虫	
哓	口尧	
澌	斯氵	
郜	告阝	
徼	彳敫	
籀	㨨竹	
陬	取阝	
蕤	甤艹	
叻	力口	
猞	犭舍	
洇	因氵	
锎	钅𫔭	
舳	由舟	
缋	纟贵	
镗	堂钅	
褙	背衤	
耋	老至	
聬	翁耳	
鳡	感鱼	
鲌	白鱼	
鰽	曹魚	
筆	竹聿	
簡	竹間	
計	十言	
語	吾言	
謂	胃言	
袴	夸衤	
巯	㐬𢀖	
吖	丫口	
猁	利犭	
桷	木角	
砼	仝石	
锾	爰钅	
颟	页𬜯	
跽	忌𧾷	
悛	夋忄	
桕	木臼	
艨	舟蒙	
颡	桑页	
髹	休髟	
桫	木沙	
鬆	松髟	
練	柬糹	
總	悤糹	
膽	月詹	
貝	八目	質
葸	思艹	
屣	尸徙	
獒	敖犬	
瘌	剌疒	
佴	亻耳	
锫	咅钅	
隰	㬎阝	
醌	昆酉	
萬	禺艹	
矯	喬矢	
鰕	叚魚	
岽	东山	
昃	仄日	
螓	秦虫	
垧	向土	
廨	广解	
骺	后骨	
黥	京黑	
豳	山豩	
議	義言	
絡	各糹	
護	蒦言	
釋	睪釆	
隨	遀阝	
荑	夷艹	
莶	佥艹	
蓊	翁艹	
揎	宣扌	
娈	亦女	
嫜	女章	
毽	建毛	
砑	牙石	
碶	契石	
剀	刂岂	
薷	艹需	
怃	忄无	
怿	忄𠬤	
骐	其马	
腧	俞月	
霈	沛雨	
蝻	南虫	
鵰	周鳥	
讀	言賣	
墼	土𣪠	
坩	土甘	
甏	彭瓦	
鹇	闲鸟	
鹣	兼鸟	
舴	乍舟	
鲭	青鱼	
傺	亻祭	
枘	内木	
秕	比禾	
糨	强米	
忉	刀忄	
磲	渠石	
顒	禺頁	
蟲	䖵虫	
訓	川言	
侑	亻有	
萁	其艹	
葳	威艹	
呙	内口	祸窝锅涡蜗娲剐
鹋	苗鸟	
貘	莫豸	
葶	亭艹	
枨	木长	
棹	卓木	
纛	毒縣	
籤	竹韱	
規	夫見	
資	次貝	
嶷	山疑	
妁	勺女	
杩	木马	
鹛	眉鸟	
羝	氐羊	
骖	参马	
祧	兆礻	
給	合糹	
淠	氵畀	
畎	犬田	
箨	择竹	
鳐	䍃鱼	
識	戠言	
遠	袁辶	
谿	奚谷	
剡	刂炎	
吲	口引	
嫫	女莫	
戽	户斗	
糗	米臭	
鸮	号鸟	
蕰	温艹	
坼	土斥	
璺	冖同玉𦥑	
栊	木龙	
镝	啇钅	
疔	丁疒	
瘰	疒累	
谮	朁讠	
辋	罔车	
碥	扁石	
豂	翏谷	
竅	敫穴	
讓	襄言	
黒	灬里	
劂	刂厥	
潋	敛氵	
孓	孓	
螋	叟虫	
鲳	昌鱼	
铙	尧钅	
塄	土𬙙	
萆	卑艹	
碲	帝石	
粋	卆米	
纻	㝉纟	
沭	术氵	
祏	石礻	
電	乚日雨	
鱲	巤魚	
頻	步頁	
設	殳言	
試	式言	
項	工頁	
鄩	尋阝	
鱖	厥魚	
鱧	豊魚	
怍	乍忄	
糍	兹米	
鸻	行鸟	
仵	亻午	
柰	木示	
棼	分林	
氇	毛鲁	
氆	普毛	
烀	乎火	
镔	宾钅	
珉	民王	
鞬	建革	
範	竹𨊠	
膠	月翏	
眾	乑罒	
鶇	東鳥	
囝	囗子	
犴	干犭	
镠	翏钅	
觇	占见	
钆	乚钅	
蚺	冉虫	
蝓	俞虫	
趑	次走	
貔	豸𣬉	
躞	燮𧾷	
氽	人水	
绂	犮纟	
栲	木考	
鹎	卑鸟	
襻	攀衤	
蓚	修艹	
貪	今貝	
祓	犮礻	
繼	㡭糹	
脫	兌月	
郿	眉阝	
骝	留马	
檫	察木	
砟	乍石	
蝰	奎虫	
猱	柔犭	
缵	纟赞	
沔	丏氵	
彖	彑𧰨	缘喙蠡篆椽
黻	犮黹	
眢	夗目	
車	車	
陳	東阝	
雜	木隹𠅃	
驚	敬馬	
龍	⑦𦚏	
鮠	危魚	
茛	艮艹	
蕈	艹覃	
骀	台马	
樨	木犀	
昝	处日	
餂	舌飠	
镎	拿钅	
酡	它酉	
鳜	厥鱼	
觋	巫见	
礅	敦石	
垆	卢土	
坻	土氐	
荇	艹行	
扃	冋户	
磻	番石	
郗	希阝	
阇	者门	
腈	月青	
铈	市钅	
臥	人臣	
顱	盧頁	
級	及糹	
階	皆阝	
顟	翏頁	
衖	亍共彳	
珙	共王	
襞	衣辟	
劁	刂焦	
隈	畏阝	
胬	奴肉	
纮	厷纟	
翙	岁羽	
茀	弗艹	
荜	毕艹	
溱	氵秦	
酤	古酉	
腳	卻月	
記	己言	
許	午言	
錯	昔金	
鱇	康魚	
圯	土巳	
柽	圣木	
瞀	敄目	
铖	成钅	
粞	米西	
撙	尊扌	
铊	它钅	
圹	土广	
菝	拔艹	
迴	回辶	
岙	夭山	
漶	患氵	
缏	便纟	
貊	百豸	
粫	米而	
徂	且彳	
洎	氵自	
礌	石雷	
膿	月農	
葉	枼艹	
險	僉阝	
雙	又雔	
餘	余飠	
邠	分阝	
邽	圭阝	
溽	氵辱	
棰	垂木	
舭	比舟	
艋	孟舟	
靜	爭青	
聱	敖耳	
尢	尢	无尤尴尬
藚	艹賣	
佾	䏌亻	
蕻	共艹镸	
狁	允犭	
绁	世纟	
牾	吾牛	
慝	匿心	
蜱	卑虫	
鬘	曼髟	
膚	胃虍	
虧	亏雐	
邊	臱辶	
髮	犮髟	
埚	呙土	
堙	土垔	
菥	析艹	
萏	臽艹	
玟	文王	
椟	卖木	
铗	夹钅	
颙	禺页	
踬	质𧾷	
筚	十笓	
矻	乞石	
搠	扌朔	
圉	囗幸	
浍	会氵	
閱	兌門	
蛸	肖虫	
礎	楚石	
討	寸言	
鎮	真金	
鮊	白魚	
芘	比艹	
萜	帖艹	
鄗	阝高	
惝	尚忄	
毵	参毛	
鲽	枼鱼	
酞	太酉	
絕	刀巴糹	
哚	口朵	
溷	圂氵	
缞	纟衰	
踰	俞𧾷	
搦	弱扌	
帻	巾责	
铦	舌钅	
鲴	固鱼	
髫	召髟	
盡	皿𭴘	
蓋	盍艹	
製	制衣	
載	車𢦏	
週	周辶	
陸	坴阝	
醡	窄酉	
儇	亻睘	
狴	坒犭	
迮	乍辶	
鍬	秋金	
趱	赞走	
椠	斩木	
赟	斌贝	
陔	亥阝	
坌	分土	
悃	困忄	
塍	土月龹	
疬	历疒	
麈	主鹿	
絜	㓞糸	
脩	丨亻𡕙	
赒	周贝	
埒	土寽	
镡	覃钅	
镨	普钅	
骎	马𠬶	
骙	癸马	
薑	畺艹	
鼩	句鼠	
雰	分雨	
穩	㥯禾	
藴	緼艹	
責	貝龶	
鮮	羊魚	
鳑	旁鱼	
豨	希豕	
琚	居王	
觫	束角	
鲦	条鱼	
刳	刂夸	
拶	扌𡿪	
掊	咅扌	
泐	氵阞	
瘗	土夹疒	
雩	亏雨	
麿	吕麻	
檗	木辟	
鼂	旦黽	
詳	羊言	
際	祭阝	
褔	畐衤	
铟	因钅	
聽	壬耳𢛳	
觸	蜀角	
靈	巫霝	
鲏	皮鱼	
蒗	浪艹	
魟	工魚	
遹	矞辶	
攴	⺊又	敲寇
蝥	敄虫	
茆	卯艹	
蓁	秦艹	
嚆	口蒿	
忮	忄支	
篌	侯竹	
菧	底艹	
卺	㔾丞	
郫	卑阝	
篠	條竹	
複	复衤	
該	亥言	
貴	貝𠀐	
辯	言辛	
飛	飛	
犰	九犭	
狳	余犭	
陠	甫阝	
蹁	扁𧾷	
蓐	艹辱	
稜	夌禾	
菃	洰艹	
埝	土念	
蕞	最艹	
喈	口皆	
戋	一戈	线钱残践浅贱盏栈笺饯
赙	尃贝	
磉	桑石	
郤	谷阝	
聍	宁耳	
铷	如钅	
硏	幵石	
腘	国月	
興	一八同𦥑	
雞	奚隹	
鬱	冖彡木缶鬯	
鳴	口鳥	
麥	來夂	
鮟	安魚	
鳈	泉鱼	
秾	农禾	
邗	干阝	
釐	里𠩺	
矧	引矢	
舁	廾臼	
貅	休豸	
瞇	目迷	
骢	悤马	
阼	乍阝	
垸	土完	
墁	土曼	
攮	囊扌	
柝	斥木	
梃	廷木	
眚	生目	
箜	空竹	
簏	竹鹿	
綮	糸𢼄	
鲩	完鱼	
諡	㿽言	
茇	犮艹	
摅	扌虑	
顐	軍頁	
蜾	果虫	
龂	斤齿	
䦟	坐門	
臍	月齊	
膩	月貳	
諸	者言	
讉	言遺	
鎯	郎金	
脒	月米	
箬	竹若	
鲻	甾鱼	
埸	土易	
颃	亢页	
蒹	兼艹	
瞍	叟目	
铫	兆钅	
蒐	艹鬼	
蹻	喬𧾷	
幞	巾菐	
阯	止阝	
觏	冓见	
媵	女月龹	
钬	火钅	
襦	衤需	
簋	皿竹艮	
翮	羽鬲	
蹯	番𧾷	
艖	差舟	
貓	苗豸	
鐮	廉金	
負	貝𠂊	
順	川頁	
鲿	尝鱼	
緊	糸臤	
蹠	庶𧾷	
攉	扌霍	
禊	契礻	
箐	竹青	
镟	旋钅	
癍	斑疒	
霪	淫雨	
袪	去衤	
劓	刂鼻	
殂	且歹	
脞	坐月	
霨	尉雨	
饾	豆饣	
耵	丁耳	
泺	乐氵	
埤	卑土	
碁	其石	
鲐	台鱼	
鷟	族鳥	
膬	月毳	
茲	艹𢆶	
粯	米見	
糞	異米	
聲	殸耳	
貼	占貝	
陴	卑阝	
橼	木缘	
驩	雚馬	
唣	口皂	
蜩	周虫	
埯	土奄	
蓥	金𫇦	
袝	付衤	
谞	胥讠	
馘	或首	
谫	剪讠	
輶	車酋	
廑	堇广	
瘐	疒臾	
躐	巤𧾷	
黟	多黑	
纔	毚糹	
礙	疑石	
膯	月登	
華	⑦艹	
藭	窮艹	
禆	卑礻	
號	号虎	饕
談	炎言	
費	弗貝	
顏	彥頁	
飯	反飠	
稓	昔禾	
縠	一冖士殳糸	
揠	匽扌	
绐	台纟	
鸰	令鸟	
搛	兼扌	
黹	㡀业	
恧	心而	
粎	尺米	
柒	㲺木	
裒	亠臼𧘇	
栳	木老	
钸	布钅	
饸	合饣	
譞	睘言	
販	反貝	
铕	有钅	
絷	执糸	
蒨	倩艹	
蓣	艹预	
迻	多辶	
釆	丿米	释悉番釉
鲕	而鱼	
頗	皮頁	
鍏	金韋	
鷉	虒鳥	
郄	阝𠫤	
埘	土时	
薤	艹𩐁	
鲞	鱼龹	
鼯	吾鼠	
坭	土尼	
蔌	欶艹	
缳	睘纟	
靦	見面	
筸	旱竹	
蘋	艹頻	
夼	大川	
椐	居木	
轹	乐车	
脬	孚月	
眍	区目	
饹	各饣	
瘥	差疒	
瘵	疒祭	
蝦	叚虫	
誌	志言	
邴	丙阝	
鉁	㐱金	
鞮	是革	
舄	勹灬臼	
麄	分鹿	
翛	丨亻夂羽	
覩	者見	
纩	广纟	
蓮	艹連	
唛	口麦	
袓	且衤	
祂	也礻	
轎	喬車	
紀	己糹	
纖	糹韱	
輔	甫車	
鉀	甲金	
領	令頁	
螵	票虫	
鸊	辟鳥	
鮡	兆魚	
禛	真礻	
袆	衤韦	
謴	言貫	
邾	朱阝	
鮣	印魚	
酲	呈酉	
龁	乞齿	
汔	乞氵	
眄	丏目	
眊	毛目	
鬲	一丅口𦉪	融隔嗝
阨	厄阝	
靸	及革	
臉	僉月	
贇	斌貝	
酺	甫酉	
狃	丑犭	
轺	召车	
霅	言雨	
鬂	兵髟	
鼷	奚鼠	
蠃	凡吂月虫	
埴	土直	
鴥	穴鳥	
隊	㒸阝	
髆	尃骨	
綱	岡糹	
膮	堯月	
謹	堇言	
铪	合钅	
鹼	僉鹵	
簳	幹竹	
終	冬糹	
綜	宗糹	
裝	壯衣	
訉	凡言	
銀	艮金	
鲉	由鱼	
蕿	煖艹	
袊	令衤	
汆	入水	
硃	朱石	
仝	人工	
趽	方𧾷	
堍	兔土	
揸	扌查	
忭	卞忄	
銧	光金	
妤	予女	
頫	兆頁	
緡	昬糹	
讟	言讀	
龠	亼𠕁𠱠	龢
垤	土至	
擐	扌睘	
噍	口焦	
洫	氵血	
滏	氵釜	
璁	悤王	
癃	疒隆	
邡	方阝	
絁	㐌糹	
鍩	若金	
趨	芻走	
蒽	恩艹	
絲	糸糹	
膫	尞月	
臅	月蜀	
茖	各艹	
蘇	穌艹	
詞	司言	
詾	匈言	
贆	猋貝	
蹨	然𧾷	
農	曲辰	
錄	彔金	
鐘	童金	
鰜	兼魚	
鹽	皿臣鹵𠂉	
赕	炎贝	
鯔	甾魚	
鯮	宗魚	
蔯	艹陳	
貙	區豸	
餬	胡飠	
躜	赞𧾷	
鳀	是鱼	
鹡	脊鸟	
䴘	虒鸟	
蠋	虫蜀	
钲	正钅	
蜁	虫𭻾	
兕	儿凹	
阽	占阝	
鎰	益金	
绋	弗纟	
铓	芒钅	
爝	火爵	
磾	單石	
葷	艹軍	
螘	虫豈	
仂	亻力	
雲	云雨	
顗	豈頁	
蟫	虫覃	
蕺	戢艹	
骃	因马	
蔀	艹部	
诪	寿讠	
猹	查犭	
鋬	扳金	
盤	皿般	
齾	獻齒	
埕	呈土	
聞	耳門	
舉	丨二與	
虡	八虚	
評	平言	
鍋	咼金	
陣	車阝	
紬	由糹	
訢	斤言	
蔎	艹設	
繸	糹遂	
绖	纟至	
埭	土隶	
駮	交馬	
鰡	留魚	
鵳	肩鳥	
柁	它木	
筴	夾竹	
珧	兆王	
贳	世贝	
贶	兄贝	
腩	南月	
臌	月鼓	
礓	畺石	
袛	氐衤	
貐	俞豸	
蹐	脊𧾷	
圬	亏土	
堠	侯土	
屦	娄尸彳	
驵	且马	
鑑	監金	
桄	光木	
霑	沾雨	
憝	心敦	
瘳	疒翏	
騃	矣馬	
茌	仕艹	
辀	舟车	
胠	去月	
埏	土延	
腠	奏月	
靰	兀革	
鞡	拉革	
缻	瓦缶	
輳	奏車	
闆	品門	
铼	来钅	
紤	斤糹	
翹	堯羽	
聯	耳𢇇	
詢	旬言	
課	果言	
豐	豆𠁳	酆
賴	束負	
輸	俞車	
遲	犀辶	
鐣	掌金	
齡	令齒	
莤	艹酉	
鱯	蒦魚	
缽	本缶	
邲	必阝	
唼	口妾	
鐻	豦金	
閟	必門	
駚	央馬	
篥	栗竹	
茈	此艹	
肏	入肉	
萩	秋艹	
跐	此𧾷	
蹅	查𧾷	
瞢	冖目𦭝	懵
罽	剡厂罒	
聭	耳鬼	
辻	十辶	
铚	至钅	
箦	竹责	
踣	咅𧾷	
菑	甾艹	
蹟	責𧾷	
捃	君扌	
瘕	叚疒	
睺	侯目	
閒	月門	
鈦	太金	
顩	僉頁	
鳓	勒鱼	
闇	門音	
鹹	咸鹵	
䥇	扇金	
禍	咼礻	
窩	咼穴	
純	屯糹	
縱	從糹	
聖	王𦔻	
聛	卑耳	
脮	妥月	
衝	亍彳重	
訊	卂言	
馬	⑥灬	
諹	昜言	
誖	孛言	
蕅	湡艹	
鰨	魚𦐇	
睒	炎目	
笰	弗竹	
籥	竹龠	
翧	宣羽	
镩	窜钅	
耧	娄耒	
蜞	其虫	
舡	工舟	
鰲	敖魚	
鹀	巫鸟	
䴙	辟鸟	
罣	圭罒	
觍	典见	
絽	吕糹	
羶	亶羊	
臜	月赞	
薙	艹雉	
觔	力角	
躼	身長	
岈	山牙	
潲	氵稍	
枧	木见	
觌	卖见	
膦	月粦	
礞	石蒙	
蝤	虫酋	
螗	唐虫	
酹	寽酉	
醅	咅酉	
絅	冋糹	
纁	熏糹	
葰	俊艹	
郇	旬阝	
躄	足辟	
茼	同艹	
洧	有氵	
滠	氵聂	
澉	敢氵	
鎭	眞金	
铏	刑钅	
閤	合門	
赆	尽贝	
赇	求贝	
顣	戚頁	
骕	肃马	
飑	包风	
訄	九言	
輓	免車	
鉤	句金	
鋹	金長	
钘	开钅	
陁	㐌阝	
耱	磨耒	
繫	糸𣪠	
鋵	秃金	
鱵	箴魚	
黨	黑𫩠	
禿	儿禾	
貧	分貝	
買	罒貝	
賈	覀貝	
榀	品木	
緣	彖糹	
膶	月閏	
茐	匆艹	
螝	虫鬼	
訙	丸言	
誘	秀言	
賦	武貝	
贅	敖貝	
鄬	爲阝	
釤	彡金	
鍵	建金	
閮	廷門	
隻	又隹	
飽	包飠	
齒	止𠚕	
鯆	甫魚	
逿	昜辶	
鮀	它魚	
鯝	固魚	
鰁	泉魚	
鱤	感魚	
郕	成阝	
镴	巤钅	
韻	員音	
鮄	弗魚	
鲙	会鱼	
鳁	昷鱼	
齁	句鼻	
舖	甫舍	
膹	月賁	
袣	世衤	
謿	朝言	
陧	圼阝	
坜	历土	
坫	占土	
甍	冖瓦罒艹	
绠	更纟	
恝	㓞心	
飗	留风	
镙	累钅	
镱	意钅	
騾	累馬	
魋	隹鬼	
硱	困石	
祫	合礻	
筍	旬竹	
箖	林竹	
袧	句衤	
迯	外辶	
郙	甫阝	
酖	冘酉	
遘	冓辶	
阘	门𦐇	
眭	圭目	
餗	束飠	
耖	少耒	
鯒	甬魚	
邶	北阝	
絼	糹豸	
颥	需页	
篚	匪竹	
鳘	敏鱼	
䥺	牙钅	
虒	虎𠂆	
裈	军衤	
遆	帝辶	
麑	兒鹿	
粚	㐌米	
託	乇言	
鄚	莫阝	
軌	九車	
饋	貴飠	
銳	兌金	
粌	引米	
紙	氏糹	
職	戠耳	
臏	月賓	
莖	巠艹	
葌	姦艹	
豬	者豕	
貏	卑豸	
違	辶韋	
鄉	乡郎	
闅	門𥄎	
闊	活門	
頂	丁頁	
飢	几飠	
驅	區馬	
魚	灬田𠂊	
鳉	将鱼	
鴱	艾鳥	
鶎	宗鳥	
黴	彳𪑛	
祼	果礻	
鬛	⑦髟龱	
镈	尃钅	
瞓	目訓	
罶	留罒	
羑	久𦍌	
黉	冖黄𭕄	
霚	敄雨	
笹	世竹	
郐	会阝	
溻	氵𦐇	
骯	亢骨	
礡	石蒪	
袉	它衤	
訚	言门	
谉	审讠	
莛	廷艹	
哕	口岁	
滗	氵笔	
瀹	氵龠	
鏰	崩金	
稃	孚禾	
眰	目至	
眳	名目	
矞	冏矛	橘谲鹬
硚	乔石	
禋	垔礻	
翀	中羽	
苾	必艹	
襕	衤阑	
趥	走酋	
茺	充艹	
軿	并車	
逌	卣辶	
唪	口奉	
庳	卑广	
殪	壹歹	
隃	俞阝	
糈	米胥	
鲄	可鱼	
龜	龜	
碕	奇石	
鲣	坚鱼	
綎	廷糹	
栝	木舌	
轵	只车	
雔	隹	
頠	危頁	
穈	禾麻	
翃	厷羽	
膭	月貴	
衒	亍彳玄	
盇	太皿	
礦	廣石	
譢	言遂	
鳰	入鳥	
遞	虒辶	
鴫	田鳥	
笟	瓜竹	
莾	奔艹	
蒼	倉艹	
蟬	單虫	
袑	召衤	
訒	刃言	
講	冓言	
讝	嚴言	
購	冓貝	
趕	旱走	
鈧	亢金	
鈩	户金	
閃	人門	
閷	杀閃	
頉	止頁	
髤	木髟	
龤	皆龠	
薿	疑艹	
鱥	歲魚	
觝	氐角	
鮻	夋魚	
鳤	管鱼	
穉	犀禾	
觱	咸角	
轘	睘車	
鐓	敦金	
筘	扣竹	
鲝	羊鱼	
睏	困目	
蔸	兜艹	
镚	崩钅	
痦	吾疒	
秵	因禾	
臎	月翠	
葴	咸艹	
蝟	胃虫	
訂	丁言	
泖	卯氵	
骟	扇马	
锽	皇钅	
犋	具牛	
眵	多目	
耩	冓耒	
筢	把竹	
躔	廛𧾷	
鬏	秋髟	
黪	参黑	
䞍	贝青	
祔	付礻	
箠	垂竹	
舲	令舟	
蒷	員艹	
蜺	兒虫	
襢	亶衤	
謺	執言	
劐	刂蒦	
貯	宁貝	
搋	扌虒	
醊	叕酉	
廒	广敖	
洚	夅氵	
胲	亥月	
韥	賣韋	
饘	亶飠	
馂	夋饣	
筅	先竹	
鳆	复鱼	
鲊	乍鱼	
麗	鹿丽	
篸	參竹	
腄	垂月	
臑	月需	
诐	皮讠	
仳	亻比	
趩	異走	
篩	師竹	
簾	廉竹	
絪	因糹	
绹	匋纟	
膵	月萃	
蕗	艹路	
蝘	匽虫	
袠	亠失𧘇	
賸	月貝龹	
葙	相艹	
遊	斿辶	
饑	幾飠	
驀	莫馬	
祪	危礻	
禘	帝礻	
臺	冖吉至	
菍	念艹	
髒	葬骨	
軸	由車	
釘	丁金	
頃	匕頁	
仉	亻几	
氕	丿气	
矔	目雚	
緒	糹者	
脅	劦月	
臒	月蒦	
苿	未艹	
菢	抱艹	
蔂	累艹	
藞	磊艹	
袩	占衤	
貞	⺊貝	
賣	士買	
跍	古𧾷	
跓	主𧾷	
蹤	從𧾷	
軍	冖車	
邿	寺阝	
鄰	粦阝	
醿	縻酉	
鈨	元金	
鋼	岡金	
駵	丣馬	
駸	馬𠬶	
鰪	盍魚	
鱾	己鱼	
䝼	貝青	
賨	宗貝	
艞	筄舟	
鹟	翁鸟	
钁	矍金	
鞓	呈革	
鰉	皇魚	
監	丶皿臣𠂉	
穊	既禾	
蕡	艹賁	
鑨	金龍	
楱	奏木	
靹	内革	
鷃	晏鳥	
鼱	青鼠	
眫	半目	
艆	舟良	
褯	席衤	
剞	刂奇	
蔟	族艹	
靿	幼革	
飭	力飠𠂉	
瘼	疒莫	
酴	余酉	
鼢	分鼠	
睆	完目	
硁	石𢀖	
秬	巨禾	
穪	爾禾	
筦	完竹	
粡	同米	
粣	册米	
綖	延糹	
裏	亠里𧘇	
刭	刂𢀖	
跼	局𧾷	
蒇	戊艹贝	
挢	乔扌	
邆	登辶	
彡	彡	形影须参修彩彭衫彪彦杉彬彰彤
猃	佥犭	
闉	垔門	
阓	贵门	
阛	睘门	
靺	末革	
鞨	曷革	
铥	丢钅	
瘅	单疒	
駰	因馬	
騻	爽馬	
箅	畀竹	
箢	宛竹	
觖	夬角	
麆	且鹿	
齮	奇齒	
糀	米花	
虯	丩虫	
瘊	侯疒	
絛	丨亻夂糸	
聴	十心罒耳	
蘭	艹闌	
讬	乇讠	
揲	扌枼	
镮	睘钅	
钷	叵钅	
睪	幸罒	睾
砲	包石	
稅	兌禾	
翫	元習	
荅	合艹	塔搭嗒瘩褡
菉	录艹	
袚	犮衤	
褋	枼衤	
贠	厶贝	
跡	亦𧾷	
踦	奇𧾷	
遯	豚辶	
鉅	巨金	
鎌	兼金	
靉	愛雲	
韲	③丫亠刀韭	
餖	豆飠	
鶺	脊鳥	
麕	囷鹿	
瞼	僉目	
菵	罔艹	
蟭	焦虫	
錏	亞金	
踐	戔𧾷	
輾	展車	
銷	肖金	
閣	各門	
頁	頁	類
驟	聚馬	
碼	石馬	
禎	礻貞	
禦	御示	
稖	咅禾	
稟	㐭禾	
竇	穴賣	
笇	卞竹	
篂	星竹	
緛	糹耎	
編	扁糹	
縿	參糹	
舊	臼萑	
蓴	專艹	
蕚	亏品艹	
蘆	盧艹	
蝿	日电虫	
袃	切衣	
親	亲見	
訴	斥言	
讕	言闌	
讚	言贊	
財	才貝	
贏	凡吂月貝	
軅	身雁	
軓	凡車	
釙	卜金	
鉄	失金	
錆	金青	
閶	昌門	
鯕	其魚	
鶕	音鳥	
麨	少麥	
䜩	燕讠	
䴗	狊鸟	
脭	呈月	
鲯	其鱼	
鐏	尊金	
魾	丕魚	
眎	目示	
睞	來目	
窋	出穴	
籠	竹龍	
綠	彔糹	
縡	宰糹	
縫	糹逢	
肅	肅	
鉏	且金	
謦	殸言	
麹	匊麦	
蔔	匐艹	
繐	惠糹	
眥	此目	
粺	卑米	
缊	昷纟	蕴
艈	㐬舟	
蓇	艹骨	
蛣	吉虫	
蹾	敦𧾷	
掎	奇扌	
哜	口齐	
鄦	無阝	
陞	阝𡉼	
韰	韭𣦼	
飖	䍃风	
镲	察钅	
麃	灬鹿	镳
禑	礻禺	
筰	作竹	
聠	并耳	
茷	伐艹	
螀	将虫	
袞	㕣亠𧘇	
褧	耿衣	
賮	貝𭴘	
赗	冒贝	
踡	卷𧾷	
揞	扌音	
遝	眔辶	
酂	赞阝	
酇	贊阝	
醜	酉鬼	
檑	木雷	
雮	毛雨	
氍	毛瞿	
腙	宗月	
飩	屯飠	
痖	亚疒	
髣	方髟	
髳	矛髟	
酎	寸酉	
鲒	吉鱼	
鲪	君鱼	
鹯	亶鸟	
麜	栗鹿	
齸	益齒	
齻	真齒	
粩	米老	
詣	旨言	
隄	是阝	
簰	牌竹	
蒾	艹迷	
蓏	㼌艹	
薳	艹遠	
藛	寫艹	
蚢	亢虫	
蓠	离艹	
蓰	徙艹	
遡	朔辶	
郋	自阝	
鄜	阝鹿	
錞	享金	
靣	丆回	
鸂	溪鳥	
麐	吝鹿	
麚	叚鹿	
齧	㓞齒	
䌷	由纟	
睊	目肙	
砢	可石	
碻	石高	
絃	玄糹	
茝	艹𦣞	
菴	奄艹	
袥	石衤	
襍	衤集	
覗	司見	
詩	寺言	
諥	言重	
跂	支𧾷	
辵	彡龰	
邅	亶辶	
醨	离酉	
頍	支頁	
疰	主疒	
觜	此角	嘴
鴿	合鳥	
笭	令竹	
糷	米蘭	
纘	糹贊	
翉	本羽	
胵	月至	
芖	大艹	
蔣	將艹	
蔦	艹鳥	
蛚	列虫	
蛯	老虫	
蜏	秀虫	
讞	獻言	
賲	保貝	
钃	屬金	
餈	次食	
馧	香𥁕	
麤	鹿	
鼶	虒鼠	
禱	壽礻	
臓	月蔵	
鈍	屯金	
錫	易金	
紛	分糹	
遙	䍃辶	
螣	䖭月	
铽	忒钅	
竝	立	
粊	比米	
紗	少糹	
紮	札糸	
絺	希糹	
絿	求糹	
緯	糹韋	
脦	忒月	
臇	月雋	
臋	殿肉	
葍	畐艹	
葞	弭艹	
葯	約艹	
葻	艹風	
藙	毅艹	
蜔	甸虫	
螕	虫𣬉	
蟻	義虫	
襲	衣龍	
觼	夐角	
觿	巂角	
詼	灰言	
諝	胥言	
貨	化貝	
賀	加貝	
趧	是走	
跉	令𧾷	
躍	翟𧾷	
軒	干車	
輪	侖車	
邉	口穴自辶	
鄶	會阝	
酁	毚阝	
釀	襄酉	
鈾	由金	
鈿	田金	
鍊	柬金	
闀	巷門	
闄	要門	
腽	昷月	
霧	務雨	
韌	刃韋	
頎	斤頁	
額	客頁	
顫	亶頁	
顬	需頁	
髿	沙髟	
鴣	古鳥	
鶝	畐鳥	
鷣	覃鳥	
齋	小齊	
鋊	谷金	
隤	貴阝	
艦	監舟	
譟	喿言	
蒉	艹贵	
磜	石祭	
綼	卑糹	
輋	大山車	
頨	羽頁	
閗	斗門	
鮍	皮魚	
鯡	非魚	
鲹	参鱼	
禣	尃礻	
粏	太米	
綿	帛糹	
臐	月熏	
迏	太辶	
鋾	匋金	
鐇	番金	
铻	吾钅	
鮼	魚𠬶	
鼈	敝黽	
込	入辶	
篰	竹部	
痄	乍疒	
睄	目肖	
磡	勘石	
窔	交穴	
筊	交竹	
羺	羊需	
腪	月軍	
臢	月贊	
荄	亥艹	
蓡	浸艹	
蝀	東虫	
詥	合言	
豀	奚谷	
苠	民艹	
郞	良阝	
骒	果马	
戤	戈盈	
铞	吊钅	
耢	劳耒	
麯	曲麥	
秱	同禾	
筼	员竹	
綈	弟糹	
翬	羽軍	
脧	夋月	
茣	吴艹	
菒	杲艹	
蓯	從艹	
蕝	絶艹	
詝	宁言	
謱	婁言	
冁	单展	
踧	叔𧾷	
茚	印艹	
辌	京车	
辒	昷车	
郪	妻阝	
鄘	庸阝	
鄠	阝雩	
帱	寿巾	
鈇	夫金	
缲	喿纟	
雚	艹𨾴	灌罐鹳獾颧
雟	屮𮥼	
韺	英音	
頵	君頁	
顝	頁骨	
镘	曼钅	
鬋	前髟	
酾	丽酉	
鳣	亶鱼	
鴦	央鳥	
麀	匕鹿	
麉	幵鹿	
麊	米鹿	
麣	嚴鹿	
藬	艹隤	
鏘	將金	
鞚	空革	
飔	思风	
鴃	夬鳥	
齏	韭齊	
礄	喬石	
誥	告言	
醲	農酉	
毳	㲎毛	撬橇
築	木筑	
絫	厽糸	
脺	卒月	
苧	宁艹	
蚘	尤虫	
蝺	禹虫	
蠶	䖵朁	
裀	因衤	
詧	②冫言𠂊	
貍	豸里	霾
踘	匊𧾷	
蹷	厥足	
蟓	虫象	
盦	皿酓	
瞆	目贵	
矰	曾矢	
磥	石累	
祮	吉礻	
稛	囷禾	
箾	削竹	
翂	分羽	
胊	句月	
蓺	埶艹	
薾	爾艹	
襱	衤龍	
覅	勿要	
讏	衞言	
跅	斥𧾷	
踆	夋𧾷	
蹔	斬足	
軐	卂車	
轪	大车	
鄤	曼阝	
醰	覃酉	
鑟	賣金	
铔	亚钅	
閛	平門	
陙	辰阝	
霳	隆雨	
顑	咸頁	
镤	菐钅	
鵲	昔鳥	
竚	宁立	
紩	失糹	
聦	怱耳	
餅	并飠	
鶄	青鳥	
競	竞	
簷	竹詹	
糵	米薛	
紖	引糹	
訪	方言	
豎	臤豆	
趦	咨走	
隸	柰隶	
禠	礻虒	
籓	潘竹	
镥	钅鲁	
盜	㳄皿	
矝	令矛	
笖	以竹	
笧	册竹	
簢	竹閔	
簻	竹過	
籌	壽竹	
粍	毛米	
綍	孛糹	
縕	糹𥁕	
罋	缶雍	
罷	罒能	
翜	夾羽	
膰	月番	
膲	月焦	
菂	的艹	
葦	艹韋	
薢	艹解	
藷	艹諸	
螞	虫馬	
蠻	䜌虫	
袀	匀衤	
袐	必衤	
覍	小見	
訌	工言	
訛	化言	
詿	圭言	
諄	享言	
譜	普言	
豈	山豆	
賢	臤貝	
賹	益貝	
遷	䙲巳辶	
釛	力金	
鈣	丐金	
鈱	民金	
鈶	台金	
鍛	段金	
鍦	施金	
鐵	金𢧜	
閯	沙門	
閺	旻門	
閻	臽門	
隂	人镸阝	
頌	公頁	
頰	夾頁	
顆	果頁	
顪	歲頁	
飼	司飠	
駕	加馬	
駝	它馬	
驌	肅馬	
驘	凡吂月馬	
鰠	蚤魚	
鰹	堅魚	
鲗	则鱼	
鶒	勅鳥	
鶗	是鳥	
鷥	絲鳥	
鷹	䧹鳥	
齊	③丨丫丿二亠刀	
硙	岂石	
禜	示𤇾	
糢	米莫	
藠	皛艹	
镦	敦钅	
蕂	勝艹	
霮	湛雨	
沩	为氵	
颼	叟風	
禬	會礻	
鴪	穴鳥	
鮨	旨魚	
鱣	亶魚	
盝	录皿	
眹	关目	
睖	夌目	
磫	從石	
禫	礻覃	
繨	糹達	
薦	廌艹	
褱	亠眔𧘇	
鏏	彗金	
鮁	犮魚	
鹓	宛鸟	
繟	單糹	
繺	煞糹	
沲	㐌氵	
餦	長飠	
篤	竹馬	
踺	建𧾷	
祦	吴礻	
篲	彗竹	
糰	團米	
絙	亘糹	
纄	糹蓬	
脝	亨月	
茊	丘艹	
菫	一口艹龶	
蓞	舀艹	
酦	发酉	
醾	糜酉	
锳	英钅	
钶	可钅	
鲼	贲鱼	
齄	查鼻	
鴨	甲鳥	
鷧	壹鳥	
㧟	扌汇	
祋	殳礻	
箯	便竹	
粐	户米	
粦	米舛	麟鳞磷粼嶙
粭	合米	
紃	川糹	
脰	月豆	
芃	凡艹	
苽	瓜艹	
莿	刺艹	
菆	取艹	
藗	艹遬	
藧	緩艹	
袵	任衤	
裯	周衤	
褵	离衤	
襆	菐衤	
詤	㠩言	
譓	惠言	
跊	未𧾷	
軈	應身	
苘	冋艹	
迺	西辶	
掭	忝扌	
邇	爾辶	
邘	于阝	
鄳	阝黽	
猸	犭眉	
艴	弗色	
鑕	質金	
柃	令木	
闒	門𦐇	
毹	俞毛	
脶	呙月	
颋	廷页	
鵀	任鳥	
鶜	茅鳥	
鶟	突鳥	
鷱	臯鳥	
鷲	就鳥	
鹍	昆鸟	
麖	京鹿	
䦆	矍钅	
軎	口車	
稂	禾良	
蒞	涖艹	
蠆	萬虫	
褲	庫衤	
佧	亻卡	
紵	宁糹	
緌	委糹	
蠾	屬虫	
裲	兩衤	
郈	后阝	
鋐	宏金	
餱	侯飠	
瓞	失瓜	
驙	亶馬	
鯙	享魚	
眆	方目	
睠	卷目	
瞫	目覃	
矅	目翟	
碃	石青	
禃	直礻	
秔	亢禾	
穻	于穴	
箇	固竹	
籐	滕竹	
絏	曳糹	
纕	糹襄	
翐	失羽	
耈	句老	
耎	大而	
脷	利月	
膕	國月	
艐	㚇舟	
艷	色豐	
苙	立艹	
葹	施艹	
蓂	冥艹	
蔲	艹𡨥	
薋	艹資	
蛷	求虫	
蜑	延虫	
衂	刃血	
衋	皕聿血	
袿	圭衤	
訕	山言	
訝	牙言	
詠	永言	
誳	屈言	
諆	其言	
讱	刃讠	
軃	單身	
轝	與車	
郀	夸阝	
郵	垂阝	
鉐	石金	
鍧	訇金	
鍼	咸金	
鏦	從金	
镵	毚钅	
閭	吕門	
闢	辟門	
陗	肖阝	
陼	者阝	
韈	蔑革	
骫	丸骨	
骳	皮骨	
骹	交骨	
髠	几髟	
髥	冄髟	
鳒	兼鱼	
鶡	曷鳥	
龒	示龍	
籂	竹飾	
翯	羽高	
莚	延艹	
萗	宗艹	
転	云車	
鄷	豊阝	
靭	刃革	
馉	饣骨	
騙	扁馬	
驊	華馬	
鼰	貝鼠	
綑	困糹	
績	糹責	
臘	巤月	
臛	月霍	
賜	易貝	
贈	曾貝	
蹣	㒼𧾷	
軡	今車	
鋸	居金	
錐	金隹	
顎	咢頁	
瞐	䀠目	
銶	求金	
钖	钅𠃓	
矊	目綿	
矘	目黨	
矚	屬目	
矡	矍矛	
硽	奄石	
磿	厤石	
礈	石遂	
礜	石與	
秲	寺禾	
窮	穴躬	
竄	穴鼠	
笗	冬竹	
箘	囷竹	
箽	竹重	
簍	婁竹	
簜	湯竹	
粷	匊米	
絨	戎糹	
絹	糹肙	
緷	糹軍	
緻	糹致	
繉	兆目糹	
繙	番糹	
罁	岡缶	
羅	維罒	
羇	䩭罒	
聣	兒耳	
聰	悤耳	
脙	月求	
脛	巠月	
脻	月疌	
脼	兩月	
腗	月畁	
艜	帶舟	
萊	來艹	
葘	艹甾	
葢	盇艹	
蔥	悤艹	
藍	監艹	
藘	慮艹	
藝	云蓺	
蘿	羅艹	
蛬	共虫	
螁	虫退	
螚	能虫	
螤	㬰蚉	
袇	丹衤	
袌	亠包𧘇	
袔	可衤	
袦	出衤	
袨	玄衤	
覂	乏覀	
訃	卜言	
訋	勺言	
詫	宅言	
詬	后言	
詮	全言	
詻	各言	
誠	成言	
謬	翏言	
譃	虚言	
譄	曾言	
譯	睪言	
譽	與言	
賰	春貝	
趮	喿走	
蹱	童𧾷	
軙	攴車	
軠	壬車	
輩	車非	
辭	辛𤔔	
遜	孫辶	
鄧	登阝	
鄫	曾阝	
鄿	蕇阝	
酀	燕阝	
釡	八金	
釢	乃金	
鉃	矢金	
鍍	度金	
鍎	盾金	
鎖	金𧴪	
闃	狊門	
鞗	丨亻夂革	
韱	㦰韭	谶
頹	禿頁	
願	原頁	
顳	聶頁	
餁	任飠	
餃	交飠	
餵	畏飠	
馮	冫馬	
馳	也馬	
駛	史馬	
騎	奇馬	
騺	執馬	
鯚	季魚	
鰟	旁魚	
鱉	敝魚	
鳛	習鱼	
鴟	氐鳥	
鴮	夸鳥	
鴲	旨鳥	
鴷	列鳥	
鷷	尊鳥	
鸀	蜀鳥	
麎	辰鹿	
麡	鹿齊	
麧	乞麥	
鼇	敖黽	
鼞	堂鼓	
鼤	文鼠	
齺	芻齒	
齽	禁齒	
龑	天龍	
裏	亠里𧘇	
䦶	争门	
䲡	酋鱼	
砮	奴石	
綟	戾糹	
緜	帛系	
繑	喬糹	
纑	盧糹	
罈	缶覃	
蠙	虫賓	
輴	盾車	
酨	酉𢦏	
鏂	區金	
駹	尨馬	
鎪	叟金	
瞕	目章	
窪	洼穴	
肻	⺊肎	
蠔	虫豪	
鐰	喿金	
綵	糹采	
鮰	回魚	
鳾	帀鳥	
虰	丁虫	
驎	粦馬	
荬	买艹	
鑛	廣金	
犏	扁牛	
鞧	酋革	
鮋	由魚	
鰷	條魚	
鶲	翁鳥	
盕	汎皿	
盩	皿𪯎	
盻	兮目	
眖	兄目	
砛	今石	
硈	吉石	
禢	礻𦐇	
禥	基礻	
窼	巢穴	
竏	千立	
筈	竹舌	
筽	吴竹	
篴	竹逐	
籆	竹蒦	
籇	竹豪	
紏	斗糹	
肣	今月	
胑	只月	
臮	人亻自	
苲	乍艹	
蒃	彖艹	
虗	丘虍	
蜌	坒虫	
跘	半𧾷	
鞦	秋革	
驄	悤馬	
鷭	番鳥	
鸼	舟鸟	
鹐	臽鸟	
矄	熏目	
魖	虚鬼	
鴐	加鳥	
薀	溫艹	
謏	叟言	
脎	月杀	
締	帝糹	
聧	癸耳	
脜	月𦣻	
艤	義舟	
荖	老艹	
蕌	晶艹	
蠷	瞿虫	
褏	③亠由𧘇	
觽	嶲角	
踫	並𧾷	
蹽	尞𧾷	
軉	寶身	
軛	厄車	
墚	土梁	
搌	展扌	
擗	扌辟	
哳	口折	
鋻	臤金	
楗	建木	
韂	詹革	
飆	猋風	
饏	敢食	
耥	尚耒	
髼	夆髟	
篼	兜竹	
鬑	兼髟	
醑	胥酉	
鴧	宂鳥	
眜	末目	
瞷	目間	
磦	石票	
礨	畾石	
祃	礻马	
祲	礻𠬶	
祻	固礻	
窊	瓜穴	
簥	喬竹	
籲	竹龥	
縢	月絭	
繌	糹𡕩	
繒	曾糹	
聜	空耳	
胔	此肉	
胾	肉𢦏	
脨	月束	
膼	月過	
艕	旁舟	
苼	生艹	
莻	叱艿	
蓨	脩艹	
蓵	捷艹	
蓾	艹鹵	
藦	摩艹	
虀	艹韲	
蚈	开虫	
蛡	羽虫	
蛻	兌虫	
蝝	彖虫	
蝹	昷虫	
蟿	虫𣪠	
衼	支衤	
褦	能衤	
襶	戴衤	
覐	爻見	
詯	自言	
誴	宗言	
諓	戔言	
謧	离言	
謪	商言	
譁	華言	
貤	也貝	
赪	贞赤	
踖	昔𧾷	
軆	豊身	
輈	舟車	
鄛	巢阝	
鄡	梟阝	
醖	昷酉	
屺	山己	
鍑	复金	
鏉	欶金	
雊	句隹	
顓	耑頁	
飐	占风	
稆	吕禾	
駳	延馬	
騽	習馬	
骍	辛马	
筻	更竹	
魱	互魚	
舣	义舟	
鮾	妥魚	
鯋	沙魚	
鯏	利魚	
鶃	兒鳥	
鶫	柬鳥	
齛	世齒	
矙	目闞	
絾	成糹	
袗	㐱衤	
襬	罷衤	
漤	婪氵	
闕	欮門	
鬐	耆髟	
鲾	畐鱼	
鴾	牟鳥	
稭	皆禾	
籄	匱竹	
聺	察耳	
褹	埶衤	
訟	公言	
鏕	金鹿	
齆	邕鼻	
盫	皿𨠭	
矎	夐目	
礋	睪石	
窌	卯穴	
簼	搆竹	
糴	籴翟	
纴	壬纟	
罵	罒馬	
翚	军羽	
耰	憂耒	
艧	舟蒦	
藇	與艹	
虖	乎虍	罅
蚖	元虫	
蜎	肙虫	
蜨	疌虫	
蠭	䖵逢	
詟	言龙	
詵	先言	
譔	巽言	
豭	叚豕	
趙	肖走	
趬	堯走	
阢	兀阝	
圊	囗青	
醃	奄酉	
録	录金	
鍮	俞金	
鍸	胡金	
闚	規門	
阤	也阝	
霫	習雨	
鞎	艮革	
韗	軍韋	
鬖	參髟	
鳠	蒦鱼	
鴼	各鳥	
鷇	一冖士殳鳥	
黇	占黄	
黡	厌黑	
齣	句齒	
盞	戔皿	
眅	反目	
磈	石鬼	
磳	曾石	
穫	禾蒦	
窅	目穴	
窾	款穴	
筭	弄竹	
箣	刺竹	
簃	移竹	
簺	塞竹	
粴	米里	
糦	喜米	
絟	全糹	
緺	咼糹	
縩	祭糹	
罍	畾缶	
翣	妾羽	
聟	知耳	
肊	乙月	
肙	口月	捐绢娟鹃涓
肞	义月	
臞	月瞿	
苶	尒艹	
菭	治艹	
葖	突艹	
蕳	艹間	
蚒	丹虫	
蜪	匋虫	
蝕	虫飠	
蠜	樊虫	
袕	穴衤	
裋	衤豆	
裩	昆衤	
褌	衤軍	
褎	③亠禾𧘇	
襫	奭衤	
覈	敫覀	
觭	奇角	
訆	丩言	
訏	于言	
訽	句言	
詨	交言	
譻	言賏	
诇	冋讠	
貑	叚豸	
跱	寺𧾷	
坶	土母	
躘	龍𧾷	
輖	周車	
轇	翏車	
轋	車連	
轕	葛車	
迒	亢辶	
郘	吕阝	
醄	匋酉	
醼	燕酉	
鋋	延金	
鏁	巢金	
鏭	悉金	
鐄	金黄	
鑣	金麃	
鑷	聶金	
辁	全车	
阸	戹阝	
牿	告牛	
鞝	尚革	
頞	安頁	
瞵	目粦	
饤	丁饣	
駃	夬馬	
駉	冋馬	
騠	是馬	
驡	馬龍	
髪	友髟	
鬚	須髟	
鬿	斤鬼	
鮌	玄魚	
鯁	更魚	
鱻	䲆魚	
鶚	咢鳥	
鷫	肅鳥	
鹖	曷鸟	
磩	戚石	
磭	石脣	
稌	余禾	
穃	容禾	
綂	糹𠑽	
膥	成末肉	
膱	戠月	
臿	千臼	插
艎	皇舟	
苃	友艹	
茍	句艹	
蒟	竘艹	
藣	罷艹	
虈	嚻艹	
蜐	劫虫	
訅	九言	
詭	危言	
讈	歷言	
貿	③刀貝	
趷	乞𧾷	
蹌	倉𧾷	
蹹	翕𧾷	
鈰	市金	
銑	先金	
鋫	利金	
鍔	咢金	
鐨	費金	
餉	向飠	
騛	飛馬	
鯛	周魚	
鰤	師魚	
鳳	几𩾏	
鵂	休鳥	
鶢	爰鳥	
鶳	師鳥	
黋	光黄	
齢	令歯	
磚	專石	
緲	眇糹	
繳	敫糹	
聝	或耳	
膴	月無	
芵	夬艹	
藫	潭艹	
覓	爫見	
誕	延言	
誡	戒言	
貎	兒豸	
賄	有貝	
跰	并𧾷	
踥	妾𧾷	
迆	也辶	
逕	巠辶	
逤	沙辶	
鏢	票金	
鏤	婁金	
鑄	壽金	
鑽	贊金	
頷	含頁	
鴉	牙鳥	
鴰	舌鳥	
麅	包鹿	
礱	石龍	
祿	彔礻	
缷	卩缶	
虙	必虍	
齗	斤齒	
裓	戒衤	
铹	劳钅	
睙	戾目	
矟	矛肖	
硣	孝石	
磹	石覃	
礀	石閒	
禮	礻豊	
秶	次禾	
窇	包穴	
竷	夂夅章	
笣	包竹	
篃	眉竹	
簬	竹路	
簯	棋竹	
粓	甘米	
粶	录米	
紋	文糹	
紓	予糹	
絞	交糹	
緹	是糹	
縷	婁糹	
縼	旋糹	
繆	糹翏	
繕	善糹	
繚	尞糹	
繞	堯糹	
绤	纟谷	
罆	缶貫	
羈	䩻罒	
翆	卆羽	
翑	句羽	
聵	耳貴	
脵	吴月	
臄	月豦	
茽	仲艹	
莊	壯艹	
莢	夾艹	
莵	⑤丶丿艹	
菕	侖艹	
蓛	敇艹	
蓷	推艹	
蓸	曹艹	
蔘	參艹	
蔞	婁艹	
蕘	堯艹	
蕼	肆艹	
薔	嗇艹	
藖	艹賢	
藢	徵艹	
藶	歷艹	
蛢	并虫	
蟯	堯虫	
蠄	禽虫	
蠈	虫賊	
蠎	莾虫	
蠣	厲虫	
襪	蔑衤	
覙	尓見	
訑	也言	
訣	夬言	
詰	吉言	
詸	米言	
誰	言隹	
諏	取言	
諛	臾言	
諮	咨言	
諱	言韋	
謥	悤言	
謨	莫言	
譫	言詹	
貋	旱豸	
貛	豸雚	
貫	毌貝	
賓	一宀貝𣥂	
賞	貝𫩠	
贁	攵貝	
贂	參貝	
贉	覃貝	
趤	宕走	
趯	翟走	
趶	于𧾷	
跔	句𧾷	
踴	勇𧾷	
蹆	退𧾷	
塥	土鬲	
輝	光軍	
輰	昜車	
輿	一八車𦥑	
轂	一冖士殳車	
邁	萬辶	
邼	匡阝	
釟	八金	
釠	几金	
釣	勺金	
鈉	内金	
鈴	令金	
鈺	玉金	
鉂	史金	
銊	戌金	
銘	名金	
鋤	助金	
鋭	兑金	
錃	波金	
錈	卷金	
漭	氵莽	
錨	苗金	
鍤	臿金	
鏆	貫金	
鐖	幾金	
鐧	金間	
鐳	金雷	
鑱	毚金	
鑾	䜌金	
镃	兹钅	
閬	良門	
閾	或門	
閿	受門	
陜	夾阝	
陝	㚒阝	
霠	今立雨	
鞏	巩革	
鞖	妥革	
韨	犮韦	
韼	逢音	
韽	酓音	
頒	分頁	
頤	頁𦣞	
顛	真頁	
飳	主飠	
飸	号食	
餆	兆飠	
館	官飠	
饅	曼飠	
駐	主馬	
駡	吅馬	
駷	束馬	
騁	甹馬	
騫	馬𡨄	
騷	蚤馬	
騼	馬鹿	
髕	賓骨	
魜	人魚	
鰫	容魚	
鱗	粦魚	
鱽	刀鱼	
鲬	甬鱼	
鴻	䲨氵	
鶆	來鳥	
鶊	庚鳥	
鷳	閒鳥	
鷿	辟鳥	
鸁	凡吂月鳥	
麞	章鹿	
鼏	冖鼎	
鼜	蚤鼓	
鼫	石鼠	
齦	艮齒	
䦂	扇钅	
䲟	印鱼	
䴓	帀鸟	
䴕	列鸟	
䶮	天龙	
盬	古皿臣𠂉	
祅	夭礻	
禡	礻馬	
禭	礻遂	
糱	米辥	
縂	总糹	
蠥	虫辥	
軷	犮車	
鄮	貿阝	
釱	大金	
銦	因金	
錣	叕金	
鑢	慮金	
钑	及钅	
饟	襄飠	
鯅	延魚	
鼊	辟黽	
䴖	青鸟	
簫	竹肅	
粛	粛	
粻	米長	
饈	羞飠	
盌	夗皿	
瞂	犮盾	
鋅	辛金	
靮	勺革	
盨	皿須	
県	小目𠃊	
箥	波竹	
簕	勒竹	
臖	月興	
鎔	容金	
鏐	翏金	
顔	彦頁	
盿	文目	
萵	咼艹	
蔊	焊艹	
覥	典見	
貲	此貝	
驢	盧馬	
鶸	弱鳥	
磑	石豈	
窎	穴鸟	
詒	台言	
鉔	匝金	
鏱	章金	
隺	冖隹	鹤榷
饜	厭食	
荘	壮艹	
蒻	弱艹	
蔴	艹麻	
裛	亠邑𧘇	
鈙	攴金	
鎋	害金	
鑀	愛金	
髴	弗髟	
鴓	必鳥	
鸴	冖鸟𭕄	
黿	元黽	
秹	任禾	
茢	列艹	
蘁	噩艹	
蚑	支虫	
鏻	粦金	
霤	留雨	
霩	郭雨	
頺	秀頁	
餚	肴飠	
鯂	酉魚	
籔	數竹	
蕁	尋艹	
蘘	艹襄	
雑	杂隹	
鬶	规鬲	
鯵	参魚	
鰧	月鮝	
鱂	將魚	
鳂	畏鱼	
鵟	狂鳥	
盠	彖皿	
盳	亡目	
盽	丰目	
眃	云目	
眏	央目	
睧	昏目	
硄	光石	
碔	武石	
碦	客石	
碸	石風	
磃	石虒	
礘	㬎石	
礮	石駮	
祘	示	蒜
禤	礻罒羽	
秌	火禾	
秙	古禾	
秢	令禾	
稧	契禾	
稬	禾耎	
稲	旧爫禾	
稸	畜禾	
穜	禾童	
竒	丷亠可	
筶	告竹	
篬	倉竹	
籒	㩅竹	
籜	擇竹	
籞	禦竹	
籶	几米	
糂	甚米	
糉	㚇米	
綡	京糹	
綶	果糹	
緄	昆糹	
緗	相糹	
緼	昷糹	
縁	彐糹𧰨	
縋	糹追	
縞	糹高	
繤	䋰艹	
繧	糹雲	
繬	嗇糹	
纃	糹齊	
纉	糹賛	
纒	㕓糹	
纗	巂糹	
罯	罒音	
羀	畱网	
耴	乚耳	
肍	九月	
腨	月耑	
膗	崔月	
膟	月率	
舦	太舟	
艊	帛舟	
菄	東艹	
葾	怨艹	
蒕	艹𥁕	
蒘	挐艹	
蒧	占茂	
蓃	叟艹	
蓆	席艹	
蔱	殺艹	
蘔	穎艹	
蟨	厥虫	
蠪	虫龍	
襖	奥衤	
誇	夸言	
謟	舀言	
讙	言雚	
谽	含谷	
踨	从龰𧾷	
躉	萬足	
躱	朶身	
輗	兒車	
釔	乙金	
鋕	志金	
鎚	追金	
韆	遷革	
鯶	軍魚	
鳋	蚤鱼	
鹒	庚鸟	
篭	竜竹	
縜	員糹	
腣	帝月	
赲	力走	
馻	允馬	
磞	崩石	
睕	宛目	
瞜	婁目	
碠	亭石	
磽	堯石	
簘	竹粛	
腃	卷月	
腵	叚月	
蓳	堇艹	
覇	䩗覀	
醱	發酉	
銝	休金	
巛	𡿨	巡巢邕
鐴	辟金	
鑵	金雚	
隩	奥阝	
颺	昜風	
飮	欠𩙿	
飰	卞飠	
餇	同飠	
饐	壹飠	
痃	玄疒	
駞	㐌馬	
鴜	此鳥	
㳠	氵达	
䁖	娄目	
睅	旱目	
睍	目見	
碭	昜石	
碽	石貢	
磸	奠石	
礉	敫石	
礽	乃礻	
祾	夌礻	
禌	兹礻	
筥	吕竹	
簴	竹虡	
紣	卆糹	
絍	任糹	
縆	恒糹	
繀	崔糹	
繃	崩糹	
羕	永𦍌	漾
羵	羊賁	
耇	句耂	
聫	大耳𢆶	
脗	月𠯳	
臯	自𠦂	
艁	告舟	
艂	夆舟	
茞	臣艹	
葨	畏艹	
蒄	冠艹	
蒭	艹芻	
薂	敫艹	
藯	慰艹	
蜆	虫見	
螑	臭虫	
蟼	敬虫	
衟	亍彳𩠐	
褑	爰衤	
褠	冓衤	
訐	干言	
訔	山言	
詖	皮言	
詗	冋言	
詪	艮言	
諈	垂言	
諑	言豖	
讌	燕言	
豗	兀豕	
豷	壹豕	
貗	婁豸	
貣	弋貝	
賯	㝁貝	
贋	貝雁	
冱	互冫	
輀	而車	
蒈	皆艹	
轓	番車	
迋	王辶	
逓	乕辶	
鄺	廣阝	
酳	幺月酉	
鈪	厄金	
尜	夵小	
鐐	尞金	
轷	乎车	
霘	洞雨	
鞄	包革	
騧	咼馬	
髽	坐髟	
魣	予魚	
鯀	系魚	
鰰	神魚	
鴹	羊鳥	
鼪	生鼠	
龔	共龍	
秊	千禾	
䴔	交鸟	
眮	同目	
笀	亡竹	
籣	竹闌	
藑	夐艹	
垲	土岂	
鍳	丶臣金𠂉	
鵬	朋鳥	
禔	是礻	
穯	吅回土禾	
茿	巩艹	
莂	别艹	
薃	滈艹	
襛	衤農	
谻	丮谷	
賚	來貝	
魳	帀魚	
鵄	至鳥	
㭎	冈木	
穄	祭禾	
穵	乙穴	挖
篛	弱竹	
簑	竹衰	
絭	糸龹	
緅	取糹	
緍	昏糹	
罇	尊缶	
耑	山而	端瑞喘揣惴湍踹
艒	冒舟	
豠	且豕	
蹎	真𧾷	
辢	束辛	
醻	壽酉	
鐍	矞金	
鑮	薄金	
闍	者門	
頳	赤頁	
驈	矞馬	
髲	皮髟	
鱮	與魚	
麰	牟麥	
鼄	朱黽	
鼅	知黽	
鼖	卉鼓	
㩳	扌雙	
眣	失目	
睎	希目	
瞣	患目	
矀	微目	
硊	危石	
碅	囷石	
磪	崔石	
礒	石義	
禞	礻高	
秠	丕禾	
穙	禾菐	
穱	爵禾	
窯	穴羔	
竢	矣立	
笍	内竹	
筩	甬竹	
篳	畢竹	
簠	盙竹	
粃	比米	
粖	末米	
糓	一冖士殳米	
糺	乚糹	
紭	弘糹	
紾	㐱糹	
絶	糹色	
綅	糹𠬶	
繂	率糹	
繋	糸軗	
繣	畫糹	
罙	㓁木	深探琛
罥	罒肙	
罼	畢罒	
羗	厶羌	
羜	宁羊	
翭	侯羽	
耮	勞耒	
聸	耳詹	
肸	八十月	
胹	月而	
脣	月辰	
腬	月柔	
膄	叟月	
膆	月素	
膋	月𤇾	
臕	月麃	
舃	②灬臼	
艫	盧舟	
艭	舟雙	
艶	色豊	
艼	丁艹	
荢	宇艹	
荳	艹豆	
萚	择艹	
蓗	徒艹	
蓱	洴艹	
蕋	歮艹	
蕟	發艹	
薐	稜艹	
薠	煩艹	
藺	艹閵	
蘓	艹𮃣	
蘪	艹麋	
虵	也虫	
蚾	皮虫	
蛖	尨虫	
蛜	伊虫	
蝍	即虫	
蝨	䖵卂	
蟂	梟虫	
蟜	喬虫	
蠏	虫解	
衕	亍同彳	
衘	亍彳𦈢	
袟	失衤	
袬	亠台𧘇	
誾	言門	
譅	歰言	
譌	爲言	
譸	壽言	
讜	言黨	
趝	念走	
趡	走隹	
跾	攸足	
踀	足𧾷	
踸	甚𧾷	
蹡	將𧾷	
垌	同土	
蹳	發𧾷	
躛	衞足	
躩	矍𧾷	
躶	果身	
軏	兀車	
軬	厶大車	
輵	曷車	
轗	感車	
轥	藺車	
逷	易辶	
遈	是辶	
邌	辶黎	
鄟	專阝	
醎	咸酉	
釭	工金	
鈸	犮金	
怊	召忄	
銌	存金	
鋂	每金	
鋎	完金	
鍐	㚇金	
鎴	息金	
鎸	金隽	
鑘	畾金	
閔	文門	
雋	④隹	
膪	啻月	
霣	員雨	
靃	雔雨	
韍	犮韋	
颩	彡風	
飦	干飠	
餔	甫飠	
駋	召馬	
騄	录馬	
骩	九骨	
骻	夸骨	
骾	更骨	
鬙	曾髟	
鬽	彡鬼	
魫	冘魚	
鯈	丨亻夂魚	
鯩	侖魚	
鯬	魚𥝢	
鰌	酋魚	
鲓	考鱼	
鴂	夬鳥	
鶍	易鳥	
鶠	匽鳥	
鷁	益鳥	
鷖	殹鳥	
鸇	亶鳥	
鸘	霜鳥	
鸧	仓鸟	
鹙	秋鸟	
麏	君鹿	
黮	甚黑	
齯	兒齒	
龓	有龍	
盓	汙皿	
眕	㐱目	
睘	罒𠮛𧘇	寰
睩	录目	
矂	喿目	
矵	刂石	
矺	乇石	
砪	母石	
硂	全石	
碒	石金	
磣	參石	
祤	礻羽	
禩	異礻	
稑	坴禾	
穐	亀禾	
穛	焦禾	
竂	尞穴	
笉	匀竹	
篟	倩竹	
篺	捭竹	
紂	寸糹	
紻	央糹	
綹	咎糹	
緐	每系	
縈	糸𤇾	
繖	散糹	
繯	睘糹	
繴	糸辟	
纀	僕糹	
羉	䜌罒	
翈	甲羽	
耡	助耒	
腀	侖月	
艩	舟齊	
苅	刈艹	
莁	巫艹	
菞	艹𥝢	
菳	艹金	
萈	丶艹見	
蒁	艹述	
蒑	殷艹	
蓔	羔艹	
蓕	桂艹	
蔙	旋艹	
蔿	爲艹	
蕧	復艹	
薆	愛艹	
薗	園艹	
薝	艹詹	
藀	熒艹	
蘌	禦艹	
虋	艹釁	
蚿	玄虫	
蜫	昆虫	
蜽	兩虫	
螥	倉虫	
蠚	䖵若	
袽	如衤	
裶	衤非	
裺	奄衤	
褣	容衤	
褸	婁衤	
詅	令言	
詇	央言	
詐	乍言	
誻	沓言	
諧	皆言	
謚	益言	
豧	甫豕	
貮	一弋貝	
賡	庚貝	
賱	貝軍	
赑	贝	
赹	匀走	
赽	夬走	
踃	肖𧾷	
蹞	頃𧾷	
蹧	曹𧾷	
躻	空身	
躿	康身	
輻	畐車	
郟	夾阝	
鄑	晋阝	
酼	㐬酉	
醁	录酉	
醕	亯酉	
醥	票酉	
釪	于金	
鈵	丙金	
銒	幵金	
銙	夸金	
鋺	宛金	
錗	委金	
錥	育金	
鍓	咠金	
鍟	星金	
鎍	索金	
鎘	金鬲	
鏿	棠金	
鐎	焦金	
鐤	金鼎	
鐿	意金	
鑊	蒦金	
锧	质钅	
閧	共門	
闛	堂門	
隝	阝鳥	
隥	登阝	
隦	辟阝	
靄	謁雨	
靱	刄革	
鞪	敄革	
鞺	堂革	
鞿	幾革	
韟	皋韋	
顀	隹頁	
飀	留風	
飥	乇飠	
飪	壬飠	
餒	妥飠	
饆	畢飠	
馿	户馬	
癀	疒黄	
驦	霜馬	
髉	隺骨	
鬉	㚇髟	
鬸	留鬲	
魛	刀魚	
鳷	支鳥	
鵋	忌鳥	
鵏	甫鳥	
鵨	舍鳥	
鵼	空鳥	
鷵	屠鳥	
鷼	間鳥	
鸍	爾鳥	
鸓	畾鳥	
鸖	霍鳥	
鹠	留鸟	
黶	厭黑	
鼉	㽞一黽	
齰	昔齒	
碀	争石	
礇	奥石	
禪	單礻	
筣	利竹	
箏	爭竹	
糧	米量	
紐	丑糹	
紳	申糹	
綀	束糹	
緱	侯糹	
缾	并缶	
羷	僉羊	
耊	耂至	
臚	月盧	
艍	居舟	
葏	津艹	
蠅	虫黽	
詛	且言	
誽	兒言	
諂	臽言	
賂	各貝	
輧	幷車	
輽	畚車	
釦	口金	
鈕	丑金	
鏍	累金	
鏽	肅金	
鐲	蜀金	
颱	台風	
饝	磨飠	
騇	舍馬	
髏	婁骨	
腂	月果	
臗	寬月	
眀	月目	
砫	主石	
祙	未礻	
祳	礻辰	
粧	庄米	
蕣	舜艹	
觓	丩角	
趹	夬𧾷	
鄍	冥阝	
鈡	中金	
羭	俞羊	
蝄	罔虫	
衸	介衤	
謡	䍃言	
閏	王門	
盪	湯皿	
眲	目耳	
睋	我目	
矃	寧目	
矒	目瞢	
硟	延石	
碩	石頁	
磄	唐石	
礂	喜石	
礊	石𣪠	
祰	告礻	
祹	匋礻	
禐	爰礻	
秳	禾舌	
秼	朱禾	
稄	夋禾	
稇	困禾	
稈	旱禾	
稘	其禾	
稙	直禾	
穢	歲禾	
竸	竟	
竾	也竹	
笐	亢竹	
笜	出竹	
筂	池竹	
箒	帚竹	
箛	孤竹	
箞	卷竹	
箤	卒竹	
箷	施竹	
箹	竹約	
箿	咠竹	
篜	烝竹	
簞	單竹	
簤	竹買	
簨	巽竹	
簹	當竹	
簽	僉竹	
籬	竹離	
粔	巨米	
粸	其米	
紇	乞糹	
紝	壬糹	
紺	甘糹	
絆	半糹	
絳	夅糹	
綄	完糹	
綊	夾糹	
綏	妥糹	
綒	孚糹	
綔	夸系	
綗	冏糹	
綴	叕糹	
緝	咠糹	
緞	段糹	
緦	思糹	
緰	俞糹	
緶	便糹	
縣	一且小系	
縹	票糹	
繜	尊糹	
繝	糹閒	
繩	糹黽	
纏	廛糹	
罃	缶𤇾	
罝	且罒	
罰	䚯罒	
羴	羊	
翢	周羽	
聡	忩耳	
聹	寧耳	
聻	漸耳	
聾	耳龍	
脕	免月	
脟	寽月	
脳	凶月𭕄	
脽	月隹	
脿	月表	
臈	月葛	
艑	扁舟	
艙	倉舟	
艢	嗇舟	
芻	勹屮	
茻	艸	
荊	刑艹	
菐	䒑业夫	噗璞
菓	果艹	
菙	垂艹	
菚	戔艹	
菣	臤艹	
菦	艹近	
菨	妾艹	
葔	侯艹	
葠	侵艹	
葮	段艹	
葲	泉艹	
蓙	座艹	
蔁	章艹	
蕛	稊艹	
蕜	悲艹	
蕦	艹須	
蕵	艹飧	
蕷	艹預	
薖	艹過	
藨	艹麃	
藮	樵艹	
藰	劉艹	
藳	稾艹	
藵	艹𧛱	
虃	瀸艹	
虘	且虍	
虜	男虍	
虝	勿虎	
蛥	多虫	
蛶	寽虫	
蜠	囷虫	
蝸	咼虫	
螐	烏虫	
螖	虫骨	
螡	䖵文	
螢	虫𤇾	
蟳	尋虫	
蠌	睪虫	
蠍	歇虫	
蠒	爾虫	
蠗	翟虫	
蠝	畾虫	
蠟	巤虫	
袘	㐌衤	
褜	胞衣	
褨	差衤	
襾	襾	
覊	䩻覀	
覚	冖見𭕄	
覛	見𠂢	
覟	志見	
覠	君見	
覯	冓見	
訜	分言	
訡	今言	
訮	开言	
証	正言	
詷	同言	
詺	名言	
諉	委言	
諒	京言	
諘	表言	
諦	帝言	
諺	彦言	
謀	某言	
謠	䍃言	
謩	莫言	
謸	敖言	
謽	强言	
讍	噩言	
讛	藝言	
貦	元貝	
貸	代貝	
貽	台貝	
賅	亥貝	
賊	戎貝	
賳	哉貝	
賺	兼貝	
贀	殹貝	
贄	執貝	
贊	兟貝	
贌	菐貝	
趪	走黃	
跁	巴𧾷	
跈	㐱𧾷	
跒	可𧾷	
蹖	舂𧾷	
軀	區身	
軇	壽身	
軔	刃車	
軘	屯車	
軣	丷八車	
軻	可車	
輒	車𦔮	
輥	昆車	
輦	㚘車	
轟	䡛車	
逇	地辶	
邔	己阝	
邥	冘阝	
邫	丰邑	
鄽	廛阝	
醆	戔酉	
醞	酉𥁕	
醽	酉霝	
釥	小金	
鈂	冘金	
鈽	布金	
鉍	必金	
鉛	口金𠘧	
銓	全金	
銜	亍彳金	
鋇	貝金	
鋒	夆金	
鋰	里金	
鋷	取金	
錠	定金	
錦	帛金	
鎲	党金	
鏈	連金	
鏟	産金	
鐑	結金	
鐬	歲金	
鑲	襄金	
鑴	巂金	
鑿	金𣫞	
镻	失镸	
閑	木門	
閰	臼門	
閳	車門	
閴	貝門	
閹	奄門	
闌	柬門	
闡	單門	
陮	阝隹	
陻	垔阝	
霂	沐雨	
靵	丑革	
鞊	吉革	
鞛	咅革	
韓	韋𠦝	
韴	帀音	
韷	出音	
頊	王頁	
頋	厄頁	
頓	屯頁	
頜	合頁	
顕	显頁	
顨	丌𩔊	
顴	雚頁	
飷	且飠	
飺	此食	
飾	巾飠𠂉	
餀	艾飠	
餌	耳飠	
餓	我飠	
饒	堯飠	
饡	贊飠	
饳	出饣	
饻	衣饣	
馴	川馬	
駜	必馬	
駣	兆馬	
駥	戎馬	
駨	旬馬	
駶	局馬	
騰	月駦	
騿	章馬	
驁	敖馬	
驇	埶馬	
驑	畱馬	
驕	喬馬	
驖	馬𢧜	
驥	冀馬	
髞	喿高	
鬀	弟髟	
鬄	易髟	
鬅	朋髟	
鬢	賓髟	
鬧	市鬥	
魰	文魚	
魵	分魚	
魸	片魚	
魺	可魚	
鯊	沙魚	
鯐	走魚	
鯓	身魚	
鯖	青魚	
鯗	䒑夫魚	
鰞	烏魚	
鰬	虔魚	
鰵	敏魚	
鰸	區魚	
鰻	曼魚	
鱌	象魚	
鱺	魚麗	
鳩	九鳥	
鳪	卜鳥	
鳶	弋鳥	
鴭	鳥𠂤	
鴳	安鳥	
鴴	行鳥	
鴵	兆鳥	
鴺	夷鳥	
鴽	如鳥	
鵁	交鳥	
鵝	我鳥	
鶈	妻鳥	
鶐	述鳥	
鶓	苗鳥	
鶩	敄鳥	
鶴	隺鳥	
鷩	敝鳥	
鷴	閑鳥	
鷽	鳥𦥯	
麩	夫麥	
麵	面麥	
鼑	⺊鼎	
鼘	鼓𣶒	
鼮	廷鼠	
齲	禹齒	
齼	楚齒	
龝	禾龜	
䦃	著钅	
䲣	攵虍鱼	
䲠	春鱼	
禖	某礻	
禵	礻題	
秅	乇禾	
竌	几立	
籙	竹録	
粵	丂丿囗釆	
緋	糹非	
羠	夷羊	
翖	合羽	
艣	舟虜	
蚡	分虫	
訹	术言	
諠	宣言	
輂	共車	
輨	官車	
遶	堯辶	
鈆	公金	
鈖	分金	
銅	同金	
鍥	契金	
鎇	眉金	
绗	纟行	
鐷	葉金	
閽	昏門	
闟	翕門	
韮	艹韭	
騣	㚇馬	
髧	冘髟	
鴢	幼鳥	
鷘	敕鳥	
黺	分黹	
祶	弟礻	
荮	纣艹	
瞏	罒袁	
稴	兼禾	
笲	弁竹	
笿	各竹	
縪	畢糹	
纍	畾糸	
翸	羽賁	
肧	不月	
臶	存至	
蜸	臤虫	
豊	曲豆	體澧醴
賁	卉貝	
輐	完車	
輘	夌車	
邏	羅辶	
雘	丹蒦	
鯽	即魚	
䓖	穷艹	
眞	八匕目𠃊	
睴	目軍	
瞡	目規	
砏	分石	
磯	幾石	
粿	果米	
紘	厷糹	
舋	且冖同𦥑	
葋	朐艹	
薭	稗艹	
虲	卜虫	
蠩	虫諸	
覵	見閒	
註	主言	
詄	失言	
譗	答言	
趰	爾走	
軧	氐車	
岍	山开	
鉼	并金	
鋪	甫金	
鞻	婁革	
颵	肖風	
餼	氣飠	
騍	果馬	
驂	參馬	
鯘	委魚	
鳿	王鳥	
龎	厂龍	
睉	坐目	
砤	㐌石	
礑	當石	
禰	爾礻	
窤	昆穴	
竈	土穴黽	
聶	耳聑	
蕒	艹買	
説	兑言	
趌	吉走	
踄	步𧾷	
鑰	金龠	
隣	粦阝	
饌	巽飠	
驛	睪馬	
骿	并骨	
鼥	犮鼠	
碵	石貞	
竤	宏立	
絒	州糹	
絓	圭糹	
芼	毛艹	
萢	泡艹	
蓧	條艹	
蔄	問艹	
螦	素虫	
詀	占言	
躦	贊𧾷	
狨	戎犭	
錋	朋金	
鎝	荅金	
鐩	遂金	
隲	少阝馬	
霝	雨𠱠	
鞟	享革	
礐	石𦥯	
禗	思礻	
稡	卒禾	
穽	井穴	
糮	監米	
羮	一夫羔	
肰	月犬	
艸	屮	
葇	柔艹	
葟	皇艹	
蒪	尃艹	
蝑	胥虫	
螧	耆虫	
蟅	庶虫	
蟢	喜虫	
貒	耑豸	
銫	色金	
関	关門	
礤	石蔡	
鮭	圭魚	
鴙	矢鳥	
鴞	号鳥	
鵣	束鳥	
鵪	奄鳥	
鷦	焦鳥	
鷺	路鳥	
齜	此齒	
盢	畎皿	
眘	目𡗜	
瞞	㒼目	
礿	勺礻	
祩	朱礻	
禨	幾礻	
秺	宅禾	
穟	禾遂	
窫	契穴	
笎	元竹	
篨	竹除	
籋	爾竹	
緤	枼糹	
緵	㚇糹	
縚	糹舀	
繿	監糹	
羙	火𦍌	
蘂	橤艹	
蜼	虫隹	
襘	會衤	
訞	夭言	
謄	月誊	
谼	共谷	
躒	樂𧾷	
躭	冘身	
迍	屯辶	
釿	斤金	
鏸	惠金	
颻	䍃風	
餟	叕飠	
餫	軍飠	
餽	飠鬼	
驆	畢馬	
鬳	虍鬲	
魒	票鬼	
盉	皿禾	
睱	叚目	
睻	宣目	
磠	石鹵	
箋	戔竹	
絣	并糹	
縀	叚糹	
縛	尃糹	
縧	條糹	
荙	艹达	
莕	杏艹	
莙	君艹	
螠	益虫	
蟧	勞虫	
襌	單衤	
襽	蘭衤	
豰	一冖士殳豕	
賷	冖十吅貝	
鉽	式金	
銲	旱金	
錧	官金	
鍚	昜金	
鍱	枼金	
骣	孱马	
鑪	盧金	
靷	引革	
頦	亥頁	
騊	匋馬	
骔	宗马	
魽	甘魚	
魿	令魚	
鮅	必魚	
鮇	未魚	
鮎	占魚	
鮘	代魚	
鮪	有魚	
鯨	京魚	
鰿	責魚	
鱀	既魚	
鱄	專魚	
鱓	單魚	
鲖	同鱼	
鴒	令鳥	
